시체와 함께 매장하는 허수아비 인형	시체와 함께 매장하는 허수아비 인형 俑
아직 벼슬자리에 오르지 않은 아들	아직 벼슬자리에 오르지 않은 아들 倅
끝의 반을 깎아 뾰족하게 한 홀	끝의 반을 깎아 뾰족하게 한 홀 璋
피륙의 짜인 날을 세는 단위 새	피륙의 짜인 날을 세는 단위 새 升
돌 을 틈물이 흐르는 모양	돌 을 틈물이 흐르는 모양 磷
불우하여 뜻을 이루지 못할	불우하여 뜻을 이루지 못할 坎
서북쪽과 북쪽의 사이 방향	서북쪽과 북쪽의 사이 방향 亥
관 꼭대기 치장하는 장식	관 꼭대기 치장하는 장식 頂
개의 빨리 달리는 모양	개의 빨리 달리는 모양 倏
머리털이길게드리워진모양	머리털이길게드리워진모양 髟
물이 줄줄 흐르는 모양	물이 줄줄 흐르는 모양 潺
밀극라니서아미크로네시아	밀극라니서아미크로네시아 密克羅尼西亞聯邦
배 희고 갈기 검은 말	배 희고 갈기 검은 말 騵
윗사람으로부터 사랑받을	윗사람으로부터 사랑받을 嬖
적진 망보는 높을 수레	적진 망보는 높을 수레 巢
죽은 사람을 따라 죽을	죽은 사람을 따라 죽을 殉
풀 성하게 우거진 모양	풀 성하게 우거진 모양 萋
고인 물 썪어 냄새날	고인 물 썪어 냄새날 瀇
곡식 셈하는 단위 휘	곡식 셈하는 단위 휘 甬 庾
구름 뭉게뭉게 일어날	구름 뭉게뭉게 일어날 英
귀인을 모시고 밥먹을	귀인을 모시고 밥먹을 侑
꿩의 깃으로 꾸민 옷	꿩의 깃으로 꾸민 옷 褕
나뭇잎 떨어져 앙상할	나뭇잎 떨어져 앙상할 槭
달 부르는 다른 이름	달 부르는 다른 이름 姮
돌이 많이 쌓인 모양	돌이 많이 쌓인 모양 磊
물결빨리내려가는 모양	물결빨리내려가는 모양 湟
산 모퉁이 우뚝 내밀	산 모퉁이 우뚝 내밀 岊
세력으로써 남을 누를	세력으로써 남을 누를 鉗
수레앞 가로막이 나무	수레앞 가로막이 나무 軾
옷이 치렁치렁한 모양	옷이 치렁치렁한 모양 裴
웃는 볼 옴쏙 들어갈	웃는 볼 옴쏙 들어갈 靨
커피의 음차로 쓰는자	커피의 음차로 쓰는자 咖
화살 빨리 가는 소리	화살 빨리 가는 소리 搜
가득 차 있는 모양	가득 차 있는 모양 睆
계집성품너그러고순할	계집성품너그러고순할 嬨
고기 꿰 다는 나무	고기 꿰 다는 나무 畢
곡식 세는 단위 휘	곡식 세는 단위 휘 籔
구슬 주렁주렁 달릴	구슬 주렁주렁 달릴 璀
귀 밑에 희끗희끗할	귀 밑에 희끗희끗할 皤
귀에 대고 소근거릴	귀에 대고 소근거릴 呫
동과 남의 사이방향	동과 남의 사이방향 巽
뜻이 크고 기개있을	뜻이 크고 기개있을 忼
목 매어 죽는 벌레	목 매어 죽는 벌레 螘
물고기 입 오물거릴	물고기 입 오물거릴 喁
부글부글 끓는 소리	부글부글 끓는 소리 泣
부인에게 예 가르칠	부인에게 예 가르칠 陰
산적 한 입에 넣을	산적 한 입에 넣을 嘬
생긋생긋 웃는 모양	생긋생긋 웃는 모양 妖
서속이 우거진 모양	서속이 우거진 모양 稶
수레뒤 가로댄 나무	수레뒤 가로댄 나무 枕
안장 얹지 않은 말	안장 얹지 않은 말 驏
얼굴의 검은 사마귀	얼굴의 검은 사마귀 靨
여럿이 힘쓰는 소리	여럿이 힘쓰는 소리 許
옷에 오색 수 놓을	옷에 오색 수 놓을 黺
입에 밥 물고 있을	입에 밥 물고 있을 嗛
재목 어긋매겨 쌓을	재목 어긋매겨 쌓을 冓
취하여 춤추는 모양	취하여 춤추는 모양 僛 傞
풀 처음 나는 모양	풀 처음 나는 모양 茁
가난하여 예절없을	가난하여 예절없을 窶
가죽 다로는 장인	가죽 다로는 장인 鞄
강과민주콩고 민주	강과민주콩고 민주 剛果民主共和國
같은 물건 네 개	같은 물건 네 개 乘
개 새끼 셋 낳을	개 새끼 셋 낳을 猥
공액민주콩고 민주	공액민주콩고 민주 公額民主共和國
구멍 큰 둥근 옥	구멍 큰 둥근 옥 瑗
그릇에 금테 두를	그릇에 금테 두를 釦
기운차고 날쌜해집	기운차고 날쌜해집 儋
나무 문질러 불낼	나무 문질러 불낼 燧
나무가지 휘늘어질	나무가지 휘늘어질 朶
남생이 등 언저리	남생이 등 언저리 冉
돌 떨어지는 소리	돌 떨어지는 소리 磅
돛대 끝 바람개비	돛대 끝 바람개비 鷁
두말이 한멍에 멘	두말이 한멍에 멘 騈
머리 끄덩이 잡을	머리 끄덩이 잡을 撮
머리털 희뜩희뜩할	머리털 희뜩희뜩할 髟
문채가 있는 모양	문채가 있는 모양 亹
물결 부딛는 형세	물결 부딛는 형세 澎
물결 부딪혀 흐를	물결 부딪혀 흐를 激
물이 흘러서 합할	물이 흘러서 합할 佩
물졸졸흐르는 모양	물졸졸흐르는 모양 潺
뭇 개 짖는 소리	뭇 개 짖는 소리 狺
발 얽은 돼지걸음	발 얽은 돼지걸음 豖
벼이삭 고개 숙일	벼이삭 고개 숙일 委
별 오른편으로 돌	별 오른편으로 돌 緯
보배로 꾸민 그릇	보배로 꾸민 그릇 鈿
봉우리 쭝굿쭝굿할	봉우리 쭝굿쭝굿할 嵱
불만족하게 생각할	불만족하게 생각할 慊
빙그레 웃는 모양	빙그레 웃는 모양 莞
빨리 흐르는 소리	빨리 흐르는 소리 潝
사직제 지낸 고기	사직제 지낸 고기 脤
산 모양이 기괴할	산 모양이 기괴할 堪
산이 높고 웅장할	산이 높고 웅장할 嶪
새짐승 우는 소리	새짐승 우는 소리 呦
샘물 흐르는 모양	샘물 흐르는 모양 泌
세 살 먹은 짐승	세 살 먹은 짐승 特
소리없이 눈물흘릴	소리없이 눈물흘릴 洵
수레 안에서 절할	수레 안에서 절할 軾
수레 앞 가로막대	수레 앞 가로막대 式
수레몰아가는 소리	수레몰아가는 소리 轟
수레통 가운데그릇	수레통 가운데그릇 橢
아첨해 웃는 소리	아첨해 웃는 소리 喔
여럿이 먹는 소리	여럿이 먹는 소리 嗿
옷 걷고 물 건널	옷 걷고 물 건널 揭
우뚝우뚝솟은 모양	우뚝우뚝솟은 모양 翹
원숭이 같은 짐승	원숭이 같은 짐승 担
질그릇 만드는 틀	질그릇 만드는 틀 膞
천둥에 비 몰아올	천둥에 비 몰아올 霣
초목 우거진 모양	초목 우거진 모양 蔚
초목이 다복히 날	초목이 다복히 날 苞
칼날 아래 코등이	칼날 아래 코등이 鐔
패를 써서 표시할	패를 써서 표시할 楬
피륙의 폭의 넓이	피륙의 폭의 넓이 綧
해 지는 산 이름	해 지는 산 이름 崦
활이 뒤로 젖혀질	활이 뒤로 젖혀질 臾
휘어만든 나무그릇	휘어만든 나무그릇 棬
가는 털 늘어질	가는 털 늘어질 冉
가늘고 성긴 베	가늘고 성긴 베 繐
가슴 두근두근할	가슴 두근두근할 怔
가을 맡은 귀신	가을 맡은 귀신 蓐
거슬러 올라 갈	거슬러 올라 갈 洄
견직물 날실 수	견직물 날실 수 絩
계단 위의 공지	계단 위의 공지 墀
고기 굵게 저밀	고기 굵게 저밀 軒
곡식 걷어 모을	곡식 걷어 모을 穩
구름 피어 오를	구름 피어 오를 滃
귀갑 지지는 불	귀갑 지지는 불 焞
그런가할 어조사	그런가할 어조사 歟
기울어 지게 설	기울어 지게 설 跛
긴 꼬리 원숭이	긴 꼬리 원숭이 猓
깊고 넓은 모양	깊고 넓은 모양 泂
나무 실은 수레	나무 실은 수레 篳
나무가지 휘어질	나무가지 휘어질 樛
남쪽으로 난 창	남쪽으로 난 창 正
높고 가파른 산	높고 가파른 산 嶂
높이 부는 바람	높이 부는 바람 飂
눈물 줄줄 흘릴	눈물 줄줄 흘릴 泣 漼 泫
다리 꺾는 형벌	다리 꺾는 형벌 鋸
단 둘러쌓은 담	단 둘러쌓은 담 壝
달에 사는 미녀	달에 사는 미녀 姮
닭 홰치는 소리	닭 홰치는 소리 腷
대궐문 아로새길	대궐문 아로새길 瑣
돌 부딪는 소라	돌 부딪는 소라 硠
돌 부딪는 소리	돌 부딪는 소리 磕
돌 튀기는 화살	돌 튀기는 화살 砲
돌산에 흙 덮일	돌산에 흙 덮일 岨
두 손으로 움킬	두 손으로 움킬 掬
말에 뛰어 오를	말에 뛰어 오를 騙
맘에 하기 싫을	맘에 하기 싫을 儢
면루관 드림 옥	면루관 드림 옥 璪
몹시 부는 바람	몹시 부는 바람 颱
무늬 놓은 비단	무늬 놓은 비단 綾
무늬 없는 비단	무늬 없는 비단 縵
물 굽이쳐 흐를	물 굽이쳐 흐를 涴
물 따라 내려갈	물 따라 내려갈 沿
물 질펀히 흐를	물 질펀히 흐를 溶
물 천천히 흐를	물 천천히 흐를 漑
물 흐르는 모양	물 흐르는 모양 滵
물 흘러 들어갈	물 흘러 들어갈 漸
물결 이는 모양	물결 이는 모양 湃
물결 출렁출렁할	물결 출렁출렁할 渫
물이 괄괄 흐를	물이 괄괄 흐를 仄
반딧불 반짝거릴	반딧불 반짝거릴 熠
발없는벌레의총칭	발없는벌레의총칭 豸
배로 실어 나를	배로 실어 나를 漕
뱃속에 든 아이	뱃속에 든 아이 夭
병기 얹는 시렁	병기 얹는 시렁 槦
불길 위로 오를	불길 위로 오를 融
불리지 않은 쇠	불리지 않은 쇠 鋽
불에 묻어 구울	불에 묻어 구울 煨
비가쏟아지는모양	비가쏟아지는모양 沛
비바람치는 모양	비바람치는 모양 瀟
사슴 우는 소리	사슴 우는 소리 呦
산이 우뚝 솟을	산이 우뚝 솟을 峙
상 앞 가로막대	상 앞 가로막대 杠
새지저귀는 소리	새지저귀는 소리 咬 啼
세 번 빚은 술	세 번 빚은 술 酎
세 살 된 짐승	세 살 된 짐승 肩
소 같은 큰 쥐	소 같은 큰 쥐 鼴
소 귀 벌룩거릴	소 귀 벌룩거릴 濕
수레 뒤턱 나무	수레 뒤턱 나무 軫
수레바퀴에 치는	수레바퀴에 치는 轢 轢
순나라 서울이름	순나라 서울이름 坂
신에 실선 두를	신에 실선 두를 紃
싸움 이긴 풍류	싸움 이긴 풍류 凱
쌀 담는 광주리	쌀 담는 광주리 筥
씨 뿌리는 기구	씨 뿌리는 기구 耬
얼이 빠져 있을	얼이 빠져 있을 偢
연달아 있는 산	연달아 있는 산 嶧
연하고 부드러울	연하고 부드러울 毳
오르락 내리락할	오르락 내리락할 頏
옥 다음가는 돌	옥 다음가는 돌 玖
이슬 많은 모양	이슬 많은 모양 瀼
일 년의 첫 날	일 년의 첫 날 元
임금이 가는 밭	임금이 가는 밭 籍 藉
자식 없는 계집	자식 없는 계집 妬
젓 담그는 형벌	젓 담그는 형벌 醢
조용히 오는 비	조용히 오는 비 零
졸졸흐르는 모양	졸졸흐르는 모양 泌
종묘의 여름제사	종묘의 여름제사 禴
죄인 주려 죽을	죄인 주려 죽을 瘐
죽어 썩지 않을	죽어 썩지 않을 殭
질 낮은 명주실	질 낮은 명주실 紇
착하고 아름다울	착하고 아름다울 媺
초목무성한 모양	초목무성한 모양 菁
촉나라 고을이름	촉나라 고을이름 犍
칼날 물에 담글	칼날 물에 담글 焠
칼로 찔러 죽일	칼로 찔러 죽일 劍
크게 저민 고기	크게 저민 고기 膴
풀 뾰죽뾰죽 날	풀 뾰죽뾰죽 날 茸
풀 우거진 모양	풀 우거진 모양 苒
풍치가 아름다울	풍치가 아름다울 媚
휙 뛰어 나아갈	휙 뛰어 나아갈 騫
힘줄 당기는 병	힘줄 당기는 병 痃
간절히 책망할	간절히 책망할 偲
개 짖는 소리	개 짖는 소리 吽
거문고 뒤치는	거문고 뒤치는 俏
거슬러 올라갈	거슬러 올라갈 溯 泝
겨드랑이에 낄	겨드랑이에 낄 掖
계집 슬기로울	계집 슬기로울 姈
고기 삶은 국	고기 삶은 국 膹
고기 잡는 풀	고기 잡는 풀 芫
고치 실 뽑을	고치 실 뽑을 繅
곰곰히 생각할	곰곰히 생각할 粤
구름 피어오를	구름 피어오를 霙 油
구멍으로 나올	구멍으로 나올 窣
궁녀 벼슬이름	궁녀 벼슬이름 婌
귀 축 늘어질	귀 축 늘어질 耽
귀밑 털 드릴	귀밑 털 드릴 鬋
그릇 얄긋거릴	그릇 얄긋거릴 行
그림 그린 활	그림 그린 활 弴
글 읽는 소리	글 읽는 소리 唔
글씨 흘려 쓸	글씨 흘려 쓸 苫
꼬리 긴 깃털	꼬리 긴 깃털 翹
날 밝으려 할	날 밝으려 할 晎
날 빛 영롱할	날 빛 영롱할 昤
너풀너풀 춤출	너풀너풀 춤출 婆
놀람의 어조사	놀람의 어조사 哦
높고 튼 모양	높고 튼 모양 巍
높이 훨훨 날	높이 훨훨 날 漂
눈 펄펄 내릴	눈 펄펄 내릴 霏
눈에 백태 낄	눈에 백태 낄 瞖
눈으로 세어볼	눈으로 세어볼 睷
눈을 깜짝이는	눈을 깜짝이는 瞬
눈을 깜짝하는	눈을 깜짝하는 瞥
느릿느릿 걸을	느릿느릿 걸을 窣
단단히 부탁할	단단히 부탁할 叮
단정의 어조사	단정의 어조사 也
닭 우는 소리	닭 우는 소리 喔
담틀 마구리대	담틀 마구리대 楨
대답하는 소리	대답하는 소리 唉
도도히 흐르는	도도히 흐르는 滔
도사리어 앉을	도사리어 앉을 跏 趺
돈짝무늬총이말	돈짝무늬총이말 驒
동해의 산이름	동해의 산이름 碣
되풀이 풀이할	되풀이 풀이할 繙
두 손 맞잡을	두 손 맞잡을 拱
두번 빚은 술	두번 빚은 술 酴
떨어지는 소리	떨어지는 소리 踏
마디 짧은 대	마디 짧은 대 莾
마음대로 날릴	마음대로 날릴 鴟
마음에 든든할	마음에 든든할 蘧 佗
많이 차려놓을	많이 차려놓을 腆
말 과격히 할	말 과격히 할 激
말 몰아 달릴	말 몰아 달릴 駸
말하려다 멈출	말하려다 멈출 囁
망령되게 말할	망령되게 말할 謣
맞부딛는 소리	맞부딛는 소리 毄
매우 큰 자라	매우 큰 자라 鼇
머리 굽실거릴	머리 굽실거릴 頊
머리 동이수건	머리 동이수건 帕
머리 풀어헤칠	머리 풀어헤칠 鬊
몸 파는 여자	몸 파는 여자 娼
못 들은채 할	못 들은채 할 聱
무늬놓은 비단	무늬놓은 비단 綺
무늬없는 비단	무늬없는 비단 絣
무두질한 가죽	무두질한 가죽 鞹
물 깊고 넓을	물 깊고 넓을 滉
물 솟아 오를	물 솟아 오를 甬
물 졸졸 흐를	물 졸졸 흐를 沇 涎 濴 湲
물 출렁출렁할	물 출렁출렁할 汪
물 콸콸 흐를	물 콸콸 흐를 沄
물결 출렁거릴	물결 출렁거릴 漾 灩
물골 터 놓을	물골 터 놓을 決
물넘치는 모양	물넘치는 모양 濊
물방울 떨어질	물방울 떨어질 涓 涿
물이 언덕 찰	물이 언덕 찰 坍
바라보는 모양	바라보는 모양 夐
바람이 쌀쌀할	바람이 쌀쌀할 觱
바위 옹두라지	바위 옹두라지 碨
발 고운 비단	발 고운 비단 綮
발 끌어 디딜	발 끌어 디딜 蹜
발 없는 벌레	발 없는 벌레 豸
방글방글 웃을	방글방글 웃을 咳 孩
방울져 떨어질	방울져 떨어질 溜
밭 넓이 단위	밭 넓이 단위 頃
번개 번쩍거릴	번개 번쩍거릴 缺 曄
벼 처음 익을	벼 처음 익을 秢 秪
보호하는 사람	보호하는 사람 垣
부드러운 나무	부드러운 나무 楢
북두 첫째 별	북두 첫째 별 樞
북소리 둥둥할	북소리 둥둥할 淵
분명하지 않을	분명하지 않을 嘸
불 이글이글할	불 이글이글할 赫
불 활활 붙을	불 활활 붙을 熾
불칙하게 말할	불칙하게 말할 嚚
비바람 몰아칠	비바람 몰아칠 瀟
뾰족하게 높을	뾰족하게 높을 嶠
산 높고 험할	산 높고 험할 嶒
산 높은 모양	산 높은 모양 礏
산 민둥민둥할	산 민둥민둥할 濯
산 불끈 솟을	산 불끈 솟을 崧
산 울뚝질뚝할	산 울뚝질뚝할 嵬 嵯
삼으로 짠 신	삼으로 짠 신 屨
새 목털 아래	새 목털 아래 翁
새가 떼로 날	새가 떼로 날 趐
샘 끓어 솟을	샘 끓어 솟을 滭
생긋생긋 웃을	생긋생긋 웃을 嫣
소 우는 소리	소 우는 소리 牟
소나무겨우살이	소나무겨우살이 蘿 蘿
손바닥으로 칠	손바닥으로 칠 挻
쇠 부어 만들	쇠 부어 만들 鑄
수레 삐걱거릴	수레 삐걱거릴 軋
수레바퀴 사이	수레바퀴 사이 軌
순임금의 신하	순임금의 신하 陶
순접의 어조사	순접의 어조사 而
신선 사는 산	신선 사는 산 瀛
쌀 뾰족뾰족할	쌀 뾰족뾰족할 驛
쌀 씻는 소리	쌀 씻는 소리 叟
아리따운 여자	아리따운 여자 媛
아이우는 소리	아이우는 소리 呱
안팎 곱사등이	안팎 곱사등이 施
애 끓는 소리	애 끓는 소리 熬
어린아이 울음	어린아이 울음 喤
언덕 위 언덕	언덕 위 언덕 宛
얼굴 아름다울	얼굴 아름다울 娃
얼굴 탐스러울	얼굴 탐스러울 艶
여럿이 걱정할	여럿이 걱정할 嗷
여자 벼슬이름	여자 벼슬이름 媛
연기에 그을릴	연기에 그을릴 焄
열 둘째 지지	열 둘째 지지 亥
옥다음가는 돌	옥다음가는 돌 瑀
옷 치렁치렁할	옷 치렁치렁할 裴
옷이 몸에 낄	옷이 몸에 낄 褊
움직이지 않을	움직이지 않을 兀
유리만드는 흙	유리만드는 흙 硅
유쾌하지 않을	유쾌하지 않을 嫌
의문의 어조야	의문의 어조야 耶
이슬방울 맺을	이슬방울 맺을 漙
이틀 밤을 잘	이틀 밤을 잘 信
입이 큰 모양	입이 큰 모양 听
저벅저벅 걸을	저벅저벅 걸을 蹀
조회 받는 곳	조회 받는 곳 宁
집 많은 동리	집 많은 동리 市
쩍쩍 씹는소리	쩍쩍 씹는소리 咤
찬양하는 노래	찬양하는 노래 頌
책 읽는 소리	책 읽는 소리 咿
코로 숨 내쉴	코로 숨 내쉴 歔
탄식의 어조사	탄식의 어조사 于
탄식하는 소리	탄식하는 소리 繄
터럭 더부룩할	터럭 더부룩할 鬆 鬙
투구의 목가림	투구의 목가림 錏
평상 가장자리	평상 가장자리 厠 廁
평평치 아니할	평평치 아니할 崴
푸성귀흉년드는	푸성귀흉년드는 饉
풀 뾰족뾰족할	풀 뾰족뾰족할 芮
하늘 가장자리	하늘 가장자리 垠
해 다니는 길	해 다니는 길 曮
해돋아 따뜻할	해돋아 따뜻할 昫
햇발이 돋아올	햇발이 돋아올 暲
활 물쩡물쩡할	활 물쩡물쩡할 騂
활 잔뜩 당길	활 잔뜩 당길 彀
활쏘기 능통할	활쏘기 능통할 送
회 섞어 바를	회 섞어 바를 垸
훌쩍나는 모양	훌쩍나는 모양 翩
휘장 친 수레	휘장 친 수레 輜
흑흑 느껴 울	흑흑 느껴 울 歔
가지런히 날	가지런히 날 簉
가지런히 할	가지런히 할 揃
간사한 모양	간사한 모양 偏
강동강동 뛸	강동강동 뛸 躅
거들어 말할	거들어 말할 慂
거듭 일러줄	거듭 일러줄 諄
검은 사마귀	검은 사마귀 黶
검푸르죽죽할	검푸르죽죽할 黲
검푸른 비단	검푸른 비단 繄
결단성 없을	결단성 없을 優
경치가 좋을	경치가 좋을 勝
계집의 이름	계집의 이름 妲
고약한 이름	고약한 이름 臭
곰곰 궁리할	곰곰 궁리할 弊
곱고 윤택할	곱고 윤택할 濡
구슬 목걸이	구슬 목걸이 珞 珞 瓔
군대 점호할	군대 점호할 閱
굴대 비녀장	굴대 비녀장 鈐
귀막이 구슬	귀막이 구슬 玧
금빛 투색할	금빛 투색할 鑂
기롱지거리할	기롱지거리할 諧
기름 덩어리	기름 덩어리 沌
기름에 지질	기름에 지질 炸
기분이 좋을	기분이 좋을 快
기운 답답할	기운 답답할 匌
길고 꼿꼿할	길고 꼿꼿할 橚
길죽한 그릇	길죽한 그릇 橢
깃발 늘어질	깃발 늘어질 綏
꽃 환히 필	꽃 환히 필 韡
꽃빛 옅어질	꽃빛 옅어질 褪
꿩 그린 옷	꿩 그린 옷 狄
끄덩이 잡을	끄덩이 잡을 總
나누어 정할	나누어 정할 夬
나무결 바를	나무결 바를 柾
날개 훨훨칠	날개 훨훨칠 泄 洩
날짐승 새끼	날짐승 새끼 雛
남부아메리카	남부아메리카 南部聯合
냄새나는 풀	냄새나는 풀 蕕
널리 알려질	널리 알려질 著
네 발 도마	네 발 도마 梡
놀라 탄식할	놀라 탄식할 惋
놀라 흩어질	놀라 흩어질 趲
놀라서 보는	놀라서 보는 瞿
놀랍고두려울	놀랍고두려울 愬
높고 가파를	높고 가파를 崔
눈 검은자위	눈 검은자위 睛
눈 아름다울	눈 아름다울 眻
눈 휘둥글할	눈 휘둥글할 諰
눈물이 흐를	눈물이 흐를 沱
눈서리 쌓일	눈서리 쌓일 凒 漼
다섯째 천간	다섯째 천간 戊
단단한 나무	단단한 나무 楨
단정하게 할	단정하게 할 攝
대가 우거질	대가 우거질 蒨
대궐안의 문	대궐안의 문 闈
댓수의 차례	댓수의 차례 佋
더듬어 걸을	더듬어 걸을 埴
더부룩히 날	더부룩히 날 包
도둑 일어날	도둑 일어날 獗
돌 굴러내릴	돌 굴러내릴 礌
돌 사닥다리	돌 사닥다리 磈
돌 자갈 땅	돌 자갈 땅 碨
동쪽 오랑캐	동쪽 오랑캐 夷
따뜻하게 할	따뜻하게 할 煦
땅 가장자리	땅 가장자리 埏 垓
떠돌아 다닐	떠돌아 다닐 宂
마을안의 문	마을안의 문 閻
마음에 먹을	마음에 먹을 佩
말 가슴걸이	말 가슴걸이 纓 鞁
말 더듬거릴	말 더듬거릴 謇 訥 聱
말 배 앓을	말 배 앓을 騫
말 우물거릴	말 우물거릴 駪
말을 더듬는	말을 더듬는 訥
맘에 든든할	맘에 든든할 委
맨손으로 칠	맨손으로 칠 暴
머리 비뚤이	머리 비뚤이 顫
며느리 발톱	며느리 발톱 距
면류관드림옥	면류관드림옥 璪
모호한 모양	모호한 모양 嘸
몸이 가벼울	몸이 가벼울 僄
문질러 훔칠	문질러 훔칠 揩
물 낀 두메	물 낀 두메 峽
물 돌아나갈	물 돌아나갈 濚 瀯
물 용솟음할	물 용솟음할 洸
물결 일렁일	물결 일렁일 瀁
물고기 그물	물고기 그물 罽
물고기 잡을	물고기 잡을 漁
물깊은 모양	물깊은 모양 瀜
물끄러미 볼	물끄러미 볼 靦 睍
물도는 모양	물도는 모양 淃 濚
물돌아 흐를	물돌아 흐를 淃
물빛이 검을	물빛이 검을 泑
물에 만 밥	물에 만 밥 飧
물이 갈래질	물이 갈래질 沱
물이 빙 돌	물이 빙 돌 澋
물이 솟아날	물이 솟아날 泡
물이 충충할	물이 충충할 奫
물이 층층한	물이 층층한 奫
물이돌아가는	물이돌아가는 匯
물흐르는모양	물흐르는모양 沇
미나리아재비	미나리아재비 茛
발꿈치 자를	발꿈치 자를 刖
발자국 소리	발자국 소리 跫
밭 거듭 갈	밭 거듭 갈 耖
배냇귀머거리	배냇귀머거리 聵
배언덕에 댈	배언덕에 댈 艤
벌레 움츠릴	벌레 움츠릴 蟄
벼 줄기 끝	벼 줄기 끝 稍
벼슬 대물릴	벼슬 대물릴 襲
벼슬의 이름	벼슬의 이름 丞
별자리 이름	별자리 이름 昴
병들어 죽을	병들어 죽을 捐
복숭아 나무	복숭아 나무 桃
부드럽게 할	부드럽게 할 揉
부르는 소리	부르는 소리 皐
부족히 여길	부족히 여길 嗛
북방 오랑캐	북방 오랑캐 狄
불 땔 나무	불 땔 나무 柴
불 번쩍거릴	불 번쩍거릴 炡
불 빛 환할	불 빛 환할 爌
불 이글글할	불 이글글할 燁 爗
불끈 일어날	불끈 일어날 暴
불린 금덩이	불린 금덩이 鈑
불쌍히 여길	불쌍히 여길 矜 憐 憫 隱
비 지정거릴	비 지정거릴 霑
비단 다섯끝	비단 다섯끝 束
비유로 간할	비유로 간할 諷
빙그레 웃을	빙그레 웃을 哂
빙글 돌아올	빙글 돌아올 倭
빛나는 모양	빛나는 모양 顥
뽕나무 열매	뽕나무 열매 葚
사나운 바람	사나운 바람 颲 頹
사냥하는 진	사냥하는 진 盂
사당문 제사	사당문 제사 祊
사슴 발자취	사슴 발자취 速
산 우뚝솟을	산 우뚝솟을 屹
살속의 가죽	살속의 가죽 膜
살피고 힘쓸	살피고 힘쓸 偲
새 보금자리	새 보금자리 巢
새 한 마리	새 한 마리 隻
생선의 창자	생선의 창자 乙
서로 못믿을	서로 못믿을 儗
서직 무성할	서직 무성할 稶
서쪽 오랑캐	서쪽 오랑캐 戎
셈하는 단위	셈하는 단위 乘
소라문솔로몬	소라문솔로몬 所羅門諸島
소리 마주칠	소리 마주칠 響
송장 뻣뻣할	송장 뻣뻣할 彊
수고롭게 할	수고롭게 할 勦
술잔을 돌릴	술잔을 돌릴 醋
술취한 모양	술취한 모양 酊
실 끝 찾을	실 끝 찾을 繹
쌀 내어 팔	쌀 내어 팔 糶
아랫배 살찔	아랫배 살찔 腴
아름다운 돌	아름다운 돌 瑨
아름다운 옥	아름다운 옥 藜 琳 琰 琬 瑤 瑜
아름답다 할	아름답다 할 歎
아첨 아니할	아첨 아니할 傋
아침을 아뢸	아침을 아뢸 晨
아홉째 지지	아홉째 지지 申
안개 자욱할	안개 자욱할 滃
얕은 금향빛	얕은 금향빛 黚
어미 원숭이	어미 원숭이 猶
어여쁜 계집	어여쁜 계집 娃
어찌 아니할	어찌 아니할 盍
얼굴 윤택할	얼굴 윤택할 脺
엉금엉금 길	엉금엉금 길 匍
여덟대 손자	여덟대 손자 耳
여덟째 천간	여덟째 천간 辛
여럿이 행함	여럿이 행함 侁
여섯째 지지	여섯째 지지 巳
여울 물소리	여울 물소리 砰
연가시 알집	연가시 알집 蛸
연기 자욱할	연기 자욱할 熢
연두빛 비단	연두빛 비단 綦
열심히 일할	열심히 일할 拮
열한째 지지	열한째 지지 戌
오랑캐 이름	오랑캐 이름 蛋 蜑 氐 筆 獯
오음의 하나	오음의 하나 羽
옥빛 찬란할	옥빛 찬란할 璀
옷 부드러울	옷 부드러울 杻
옷 치렁거릴	옷 치렁거릴 袁
옷에 솜 둘	옷에 솜 둘 褚
옷자락 꽂을	옷자락 꽂을 襭
외나무 다리	외나무 다리 杠 榷
요사스런 말	요사스런 말 譌
요사스런 별	요사스런 별 旬
우두커니 설	우두커니 설 站
우연히 만날	우연히 만날 邂
웅크리고 볼	웅크리고 볼 耽
윗사람 죽일	윗사람 죽일 弑
윤태하게 할	윤태하게 할 洽
음란한 소리	음란한 소리 哇
인정머리없을	인정머리없을 偸
일곱째 천간	일곱째 천간 庚
일찍 일어날	일찍 일어날 夙
임금의 신분	임금의 신분 位
입 딱 벌일	입 딱 벌일 呿 哆
입 비뚤어질	입 비뚤어질 咼
잇속 드러날	잇속 드러날 矧
저녁 곁두리	저녁 곁두리 餔
조나라 서울	조나라 서울 鄲
죄인 자물쇠	죄인 자물쇠 鐺
줄이 느런할	줄이 느런할 岬
진중치 못할	진중치 못할 僄
착하고 어질	착하고 어질 元
창으로 찌를	창으로 찌를 戳
천천히 걸을	천천히 걸을 邌 辿
천천히 말할	천천히 말할 謜 頰
춤추는 모양	춤추는 모양 娟
칼 장식 옥	칼 장식 옥 珌
콩 삶은 물	콩 삶은 물 灝
큰소리 지를	큰소리 지를 吳
턱 끄덕거릴	턱 끄덕거릴 吟
파뜩파뜩 날	파뜩파뜩 날 翾
풀 더부룩할	풀 더부룩할 葆
풀보기 잔치	풀보기 잔치 餪
풀이 우거진	풀이 우거진 莽
풍류 조화될	풍류 조화될 龢
풍세보는 깃	풍세보는 깃 俔
피변 꾸미개	피변 꾸미개 璂
피부병 이름	피부병 이름 瘯
학문 통달할	학문 통달할 詣
햇볕에 말릴	햇볕에 말릴 曝
햇빚 뜨거울	햇빚 뜨거울 炚
향기로운 풀	향기로운 풀 鬱
향내나는 풀	향내나는 풀 蕓
헌 옷 기울	헌 옷 기울 緻
험윤 오랑캐	험윤 오랑캐 獫
험하고 높을	험하고 높을 磪
화폐의 단위	화폐의 단위 圓
회오리 바람	회오리 바람 搖
흑백의 잡색	흑백의 잡색 龐
가깝게 할	가깝게 할 昵
가는 갈포	가는 갈포 絺
가는 소리	가는 소리 唎
가는 칡베	가는 칡베 絺
가는 허리	가는 허리 嫢
가라 앉을	가라 앉을 沒
가랑비 올	가랑비 올 濛
가려 숨길	가려 숨길 翳
가마테나무	가마테나무 樻
가물 귀신	가물 귀신 魃
가슴 만질	가슴 만질 摽
가지런 할	가지런 할 侔
갈래진 창	갈래진 창 戟
갑작스러울	갑작스러울 勃
강새암 할	강새암 할 媢
강아지 풀	강아지 풀 稂
개구리소리	개구리소리 閤
갸웃이 볼	갸웃이 볼 闚
거룩하다할	거룩하다할 欹
거마 소리	거마 소리 輧
거북 덮개	거북 덮개 屋
거슴츠레한	거슴츠레한 瞞
거친 숫돌	거친 숫돌 礪 磏
거푸집 속	거푸집 속 鑲
걱정 없을	걱정 없을 恝 恝
걷어 올릴	걷어 올릴 裍
걸터 앉을	걸터 앉을 倨
검은 기장	검은 기장 秬
검은 암양	검은 암양 羖
곁눈질 할	곁눈질 할 盼
고개 이름	고개 이름 隴
고기 삶을	고기 삶을 腤
고기 이름	고기 이름 鰊
고깔꾸미개	고깔꾸미개 璂
고약 붙일	고약 붙일 熨
고을 이름	고을 이름 瑯 郫 郅 郪 郝 邯
고집스러울	고집스러울 狷 拗
곡식 익을	곡식 익을 歲
골짝 사이	골짝 사이 嶰
공교한 말	공교한 말 諞
구름 무늬	구름 무늬 雯
구슬 꿰미	구슬 꿰미 琲
구슬 이름	구슬 이름 玭
국경 지킬	국경 지킬 役
굳게 얽힐	굳게 얽힐 緊
굴대 머리	굴대 머리 軹
굵은 마늘	굵은 마늘 葫
굶어 죽을	굶어 죽을 殍
귀막이 옥	귀막이 옥 瑩 珥
귀바퀴없는	귀바퀴없는 聃
그릇 부실	그릇 부실 盪
근심스러울	근심스러울 騷
금석 소리	금석 소리 鏗
금옥 소리	금옥 소리 鏘
기름진 땅	기름진 땅 堉
기운 성할	기운 성할 氳
기운 어릴	기운 어릴 氳
긴 물줄기	긴 물줄기 演
길이 단위	길이 단위 呎
깃대 장식	깃대 장식 旄
깃발 날릴	깃발 날릴 旆 髟
깊게 붉은	깊게 붉은 絳
깊게 붉을	깊게 붉을 絳
깜짝 놀랄	깜짝 놀랄 怛 灑
깨끗한체할	깨끗한체할 瑟
깨우쳐 줄	깨우쳐 줄 喩
껄껄 웃을	껄껄 웃을 渠 軒
꼭 그러할	꼭 그러할 的
꿈실거리는	꿈실거리는 蠢
끊어 죽일	끊어 죽일 夭
나누어 줄	나누어 줄 俵
나라 곳집	나라 곳집 帑
나라 이름	나라 이름 龜 鄧 藜 邠 豳 韓 邢
나란히 할	나란히 할 騈 騈
나무 깍을	나무 깍을 彔
나무 무늬	나무 무늬 橒
나무 이름	나무 이름 杞 梛 欒 榔 柏 枌 萇
나무빽빽할	나무빽빽할 森
날뛰는 말	날뛰는 말 驤
남녀의 정	남녀의 정 春
남해 임금	남해 임금 儵
낮은체 할	낮은체 할 巽
내려다 볼	내려다 볼 瞰
냄새 퍼질	냄새 퍼질 炙
너울너울할	너울너울할 與
네째 천간	네째 천간 丁
노둔한 말	노둔한 말 駑
놀라게 할	놀라게 할 嚇
놀라서 볼	놀라서 볼 瞿
높고 험할	높고 험할 嶔
높고밝은땅	높고밝은땅 塽
높은 가지	높은 가지 標
높이 솟을	높이 솟을 巑
눈 깜작일	눈 깜작일 瞬 眨
눈들고 볼	눈들고 볼 頣
눈썹 그릴	눈썹 그릴 黛
눈에백태낄	눈에백태낄 眚
다룬 가죽	다룬 가죽 韋 鞣
다리굽은솥	다리굽은솥 鬲
다섯 사람	다섯 사람 伍
다섯째지지	다섯째지지 辰
달게 먹을	달게 먹을 噥
달게 여길	달게 여길 甘
달음박질할	달음박질할 鋌
대 사립문	대 사립문 篳
대궐 섬돌	대궐 섬돌 陛
대궐 층계	대궐 층계 劫
대나무이름	대나무이름 筬
도깨비 불	도깨비 불 粦
도끼 구멍	도끼 구멍 銃
돌 갈라질	돌 갈라질 泐
돌 비탈길	돌 비탈길 磴
돌아 누울	돌아 누울 輾
두리번거릴	두리번거릴 矍
둥글길죽할	둥글길죽할 橢
드러난 뼈	드러난 뼈 骼
들추어 낼	들추어 낼 訐
따라 죽을	따라 죽을 徇
때려 부술	때려 부술 戌
떨기로 날	떨기로 날 稹
떼지어 갈	떼지어 갈 侁
똑바로 볼	똑바로 볼 睟 瞠
뜻에 맞을	뜻에 맞을 愜
마른 가죽	마른 가죽 鞣
마른 나무	마른 나무 藁
마른 누에	마른 누에 殭
마른밥가루	마른밥가루 糗
마음 변할	마음 변할 貳
마음 졸일	마음 졸일 惄
마지 않을	마지 않을 繾
마헐이마셜	마헐이마셜 馬歇爾諸島
많은 모양	많은 모양 莘
말 더듬을	말 더듬을 吶 吟
말 아니할	말 아니할 嘿
말 허구리	말 허구리 腔
말린 과실	말린 과실 脯
말오줌나무	말오줌나무 芨
말이 뛰놀	말이 뛰놀 秋
맑은 대쑥	맑은 대쑥 萩 苹
맑은 소리	맑은 소리 激
맛이 좋을	맛이 좋을 美
망녕된 말	망녕된 말 譃
매미 허물	매미 허물 蛻
매운 채소	매운 채소 葷
맥박 잦을	맥박 잦을 弦
머리 깍을	머리 깍을 髡
머리 깎을	머리 깎을 剃
머리 늘일	머리 늘일 髟
머리 묶을	머리 묶을 髺
머리 숙일	머리 숙일 頫
머리꾸미개	머리꾸미개 珈
머리치장할	머리치장할 嬰
먹기 싫을	먹기 싫을 飫 飽
먹줄 튀길	먹줄 튀길 絣
멀구슬나무	멀구슬나무 楝
메마른 땅	메마른 땅 磽 塉
메마른 밭	메마른 밭 墝
모양 형상	모양 형상 狀
모여 말할	모여 말할 讌
목긴 술병	목긴 술병 墰
몰아 잡을	몰아 잡을 攝
몸 주무를	몸 주무를 杬
묘 구덩이	묘 구덩이 宅
무게 단위	무게 단위 鍰
무궁화나무	무궁화나무 橓 櫬
무늬진 돌	무늬진 돌 碭
문 두드릴	문 두드릴 啄
물 갈라질	물 갈라질 渚 港
물 그득할	물 그득할 灩
물 끌어올	물 끌어올 澆
물 속 돌	물 속 돌 碤
물 아득할	물 아득할 淼
물가 언덕	물가 언덕 岸 墺 隩
물건 빛날	물건 빛날 釉
물고기 알	물고기 알 鯤
물귀신이름	물귀신이름 馮
물에 젖을	물에 젖을 汝
물이 넘칠	물이 넘칠 衍
물이 번질	물이 번질 沮
물푸레나무	물푸레나무 槻
뭍 배질할	뭍 배질할 盪
미쳐 날뛸	미쳐 날뛸 猖
밀리메트로	밀리메트로 粍
바르게 할	바르게 할 政
바퀴 자국	바퀴 자국 轍
반둥근패옥	반둥근패옥 璜
발 부르틀	발 부르틀 繭
발끈 성낼	발끈 성낼 毅 悻
밝게 살필	밝게 살필 僬
방아 찧을	방아 찧을 舂
배 뚱뚱할	배 뚱뚱할 肛
배 불룩할	배 불룩할 皤 膨
배로실어올	배로실어올 漕
뱃속 결릴	뱃속 결릴 痞
버들 고리	버들 고리 筽
버마 재비	버마 재비 螳
번쩍번쩍할	번쩍번쩍할 燁 爗
벌레 이름	벌레 이름 蜵
베어 없앨	베어 없앨 翦
벼슬 차례	벼슬 차례 品
부끄러워할	부끄러워할 愧 怩 羨 羞
부스럼자국	부스럼자국 瘢
부족 이름	부족 이름 契
북방 종족	북방 종족 貊
불 깐 개	불 깐 개 猗
불기운성할	불기운성할 燻
불끈 성낼	불끈 성낼 咆
불쌍히여길	불쌍히여길 惻
불에 말릴	불에 말릴 煎 爋
불에 익힐	불에 익힐 燮
붉은 비단	붉은 비단 緹
비 쏟아질	비 쏟아질 沛 霈
비 퍼부을	비 퍼부을 滂
비단 쑥색	비단 쑥색 綥
비문 박을	비문 박을 搨
비와 이슬	비와 이슬 澤
빙그레웃을	빙그레웃을 莞
빙빙돌아날	빙빙돌아날 翔
빨리 걸을	빨리 걸을 駪
빨리 흐를	빨리 흐를 淢
뼛속 기름	뼛속 기름 髓
뿔없는 용	뿔없는 용 虯
사나운 개	사나운 개 獒
사나운 말	사나운 말 駻
사냥 수레	사냥 수레 軨
사람 가릴	사람 가릴 銓
사람 이름	사람 이름 媧 禝 瓆
사람의 성	사람의 성 金
사랑스러울	사랑스러울 姸
사이에 낄	사이에 낄 俠
사지 떨릴	사지 떨릴 顫
사지 틀릴	사지 틀릴 癱
산 가파를	산 가파를 嶮
산 꼭대기	산 꼭대기 巓
산 비알질	산 비알질 岥
산 뾰족할	산 뾰족할 岏 嵬
산 우뚝할	산 우뚝할 岦 崔
산 웅장할	산 웅장할 崧
산 허구리	산 허구리 岬
산골 도랑	산골 도랑 畎
산골 시내	산골 시내 磵
산높은모양	산높은모양 嶪
산앵두나무	산앵두나무 棣
산이 높을	산이 높을 岧
삵의 새끼	삵의 새끼 狉
상고 신인	상고 신인 倧
상수리나무	상수리나무 櫟 橡 栃
새 지저귈	새 지저귈 囀
색에 빠질	색에 빠질 嫖
서로 부를	서로 부를 喁
성낸 소리	성낸 소리 喝
성문 층대	성문 층대 闍
성한 모양	성한 모양 侊
세게 뿜을	세게 뿜을 嘯
세발 가마	세발 가마 錡
세발 마름	세발 마름 芰
세수 그릇	세수 그릇 洗
소리 높일	소리 높일 叴
소리 맑을	소리 맑을 喨
소리 맞을	소리 맞을 韻
소리 약할	소리 약할 低
소리 울릴	소리 울릴 響
소리 읽힐	소리 읽힐 囉
소리없이울	소리없이울 泣
소매 아귀	소매 아귀 袪
소반 뚜껑	소반 뚜껑 盒
소흘히 할	소흘히 할 忽
손아랫누이	손아랫누이 妹
솟을 대문	솟을 대문 閬
쇠북 꼭지	쇠북 꼭지 甬
수레 굴대	수레 굴대 鍵
수레 소리	수레 소리 轔
수레 안장	수레 안장 幰
수레 한채	수레 한채 輛
수리부엉이	수리부엉이 鵂
수염 깎을	수염 깎을 鬋
순의 풍류	순의 풍류 韶
순한 모양	순한 모양 倭
숨 들이쉴	숨 들이쉴 吸 噏
스물넉냥쭝	스물넉냥쭝 鎰
시간 단위	시간 단위 秒
시원한 땅	시원한 땅 塏
신통한 양	신통한 양 獬
심줄 땅길	심줄 땅길 痙
싸서 구울	싸서 구울 炮
쌀 사들일	쌀 사들일 糴
씹어 먹을	씹어 먹을 哺
아롱 짐승	아롱 짐승 犳
아롱비둘기	아롱비둘기 鵻
아름다운돌	아름다운돌 珉
아름다운옥	아름다운옥 琨 璿 璇
아름답다할	아름답다할 欹
아릿아릿할	아릿아릿할 硜
아이 낳을	아이 낳을 姓
아홉째천간	아홉째천간 壬
안간힘 쓸	안간힘 쓸 喑
알랑알랑할	알랑알랑할 硜
암메추라기	암메추라기 痺
야청 통견	야청 통견 繰
약물 중독	약물 중독 癩 癩
어리둥절할	어리둥절할 慌
어미원숭이	어미원숭이 爲
어슴푸레할	어슴푸레할 宛
어지러워질	어지러워질 紛
얼굴 붉힐	얼굴 붉힐 赧
엄지손가락	엄지손가락 拇 擘
엉금엉금길	엉금엉금길 匐
여관 이름	여관 이름 娙
여자 이름	여자 이름 嬅
역귀 쫓을	역귀 쫓을 儺
역말 수레	역말 수레 遽
열심히일할	열심히일할 拮
열째 지지	열째 지지 酉
열째 천간	열째 천간 癸
예쁜 여자	예쁜 여자 娵
예쁜체 할	예쁜체 할 嬈
오나라 배	오나라 배 舡
오락가락할	오락가락할 斐 翩
오랑캐 꽃	오랑캐 꽃 菫
오랑캐이름	오랑캐이름 犵
옥 다듬을	옥 다듬을 琢 鎚
온공스러울	온공스러울 恂
옳게 여길	옳게 여길 允
옳이 여길	옳이 여길 肯
옷 덧입을	옷 덧입을 襲
옷 뒷자락	옷 뒷자락 裾 裔
옷 빼앗을	옷 빼앗을 褫
외뿔난 소	외뿔난 소 兕
우나라태학	우나라태학 庠
우두커니설	우두커니설 佇
우뚝 솟을	우뚝 솟을 嵯 矗
우뚝선 돌	우뚝선 돌 碣
우러러 볼	우러러 볼 梓
우물 벽돌	우물 벽돌 甃
우제 지낼	우제 지낼 虞
우지직거릴	우지직거릴 窣
운우 모양	운우 모양 霌
웃는 소리	웃는 소리 嗑
웃옷 벗을	웃옷 벗을 袒
위엄스러울	위엄스러울 赳
유월 더위	유월 더위 溽
으르렁거릴	으르렁거릴 哮
으르릉거릴	으르릉거릴 咆
음력 시월	음력 시월 亥
이 어긋날	이 어긋날 齟
이문 남길	이문 남길 贏
이슬 기운	이슬 기운 瀣
이슬 맺힐	이슬 맺힐 泫
이지러지는	이지러지는 騫
인동 덩굴	인동 덩굴 蒡
일찍 죽을	일찍 죽을 夭
임금의 호	임금의 호 炎
자갈 먹일	자갈 먹일 拑
자라똥구멍	자라똥구멍 醜
자질구레할	자질구레할 微
작은 가시	작은 가시 蒂
작은 가시	작은 가시 蔕
작은 모양	작은 모양 芾
작은 술잔	작은 술잔 盞
잘게 부슬	잘게 부슬 僿
잠 깨어날	잠 깨어날 寤
잠깐 머물	잠깐 머물 佇
장사 지낼	장사 지낼 葬
재난의 뒤	재난의 뒤 燼
재채기 할	재채기 할 嚏
저울 바탕	저울 바탕 鋺
적게 여길	적게 여길 小
절인 생선	절인 생선 鮑
정성스러울	정성스러울 慺 諄 肫 愼 叮
정한 쌀밥	정한 쌀밥 粲
제기 이름	제기 이름 籩 簠
제사 고기	제사 고기 膰
조개 이름	조개 이름 硨
조리 돌릴	조리 돌릴 徇 侚
종기 아플	종기 아플 疳
종묘 제기	종묘 제기 彝
종아리 칠	종아리 칠 捶
좋은 사람	좋은 사람 凱
죄 의논할	죄 의논할 讞
죄 조사할	죄 조사할 訊
주름 비단	주름 비단 縠
죽은 어미	죽은 어미 妣
준마 이름	준마 이름 鯤
줄에 달릴	줄에 달릴 縋
진한 유즙	진한 유즙 酪
진흙 묻을	진흙 묻을 涴
질긴 고기	질긴 고기 靭
짐승 그물	짐승 그물 罝
짐승 이름	짐승 이름 貘
짐승의 뼈	짐승의 뼈 骼
집 마룻대	집 마룻대 檼
짚 고갱이	짚 고갱이 秸
쪽찐 머리	쪽찐 머리 鬟
찔러 밀칠	찔러 밀칠 摽
차는 수건	차는 수건 帨
차려 입을	차려 입을 裝
차례로옮길	차례로옮길 推
채소 이름	채소 이름 芚
책상다리할	책상다리할 跏 趺
처마 기슭	처마 기슭 宇
천간 이름	천간 이름 乙
천상바라기	천상바라기 籧 尫
천자의 옷	천자의 옷 袞
천천히 할	천천히 할 曳
첫째 천간	첫째 천간 甲
초목 성할	초목 성할 葳
촉규화벌레	촉규화벌레 蜀
추렴 걷을	추렴 걷을 醵
춤추는모양	춤추는모양 娑
취한 모양	취한 모양 酩
치마걷어들	치마걷어들 摳
칠한 술통	칠한 술통 槪
칼 손잡이	칼 손잡이 鋏
칼 쓰는법	칼 쓰는법 劍
칼집 장식	칼집 장식 琫
칼집장식옥	칼집장식옥 琫
칼철갑상어	칼철갑상어 鱏
콩 꼬투리	콩 꼬투리 莢
크게 부를	크게 부를 欬
큰 가물치	큰 가물치 鰹
큰 기러기	큰 기러기 鴻
킬로메트르	킬로메트르 粁
텁텁한 술	텁텁한 술 醲
토지의 신	토지의 신 祇 社
파랑강충이	파랑강충이 蚨
표현 못할	표현 못할 悱
푸닥거리할	푸닥거리할 祓 禳
풀 더북할	풀 더북할 葱 蓯
풀 무성할	풀 무성할 菶 芊
풀 우거질	풀 우거질 芼 茀 苒
풀 줄거리	풀 줄거리 莛
풍류 마칠	풍류 마칠 闋
한데 뒷간	한데 뒷간 匽
햇빛 밝을	햇빛 밝을 昱
햇빛 쪼일	햇빛 쪼일 暴
햇살 치밀	햇살 치밀 旭
햇살 퍼질	햇살 퍼질 晟
허리 가늘	허리 가늘 偠
허허 웃을	허허 웃을 咥
헌데 딱지	헌데 딱지 痂
형벌 이름	형벌 이름 墨
홀치기염색	홀치기염색 纈
화장 상자	화장 상자 奩
활 뒤틀릴	활 뒤틀릴 彆
황후의 옷	황후의 옷 翟
회오리바람	회오리바람 飄 飇
후한 제사	후한 제사 穠
휑덩그렁할	휑덩그렁할 渠
휑뎅그렁할	휑뎅그렁할 岈
휙 달아날	휙 달아날 攸
흐리멍덩할	흐리멍덩할 憧
흠치르르할	흠치르르할 灄 浥
희뜩희뜩할	희뜩희뜩할 星
힉터메트르	힉터메트르 粨
힘 빼두를	힘 빼두를 偈
가까이할	가까이할 殆
가는 대	가는 대 笹 篠 筱
가는 베	가는 베 絨
가는 실	가는 실 緬 糸
가는 털	가는 털 毫
가다가설	가다가설 遝
가라앉을	가라앉을 沈 沈
가래나무	가래나무 椅 梓 楸 萩
가마우지	가마우지 鸕 鶿
가막조개	가막조개 蜆
가물거릴	가물거릴 偎
가슴걸이	가슴걸이 鞅 靷
가시 대	가시 대 笆
가시나무	가시나무 棘 茨
가시연밥	가시연밥 芡
가을하늘	가을하늘 旻
가죽나무	가죽나무 樗
가죽다룰	가죽다룰 碟
가죽바지	가죽바지 韐
가지런할	가지런할 等 勻 整 齊
가축우리	가축우리 牢
가치있을	가치있을 値
갈가마귀	갈가마귀 鴉 鵯
갈고랑쇠	갈고랑쇠 鉤
갈래머리	갈래머리 妑
갈잎피리	갈잎피리 笳
감람나무	감람나무 橄 欖
감매나무	감매나무 楮
갓난아이	갓난아이 嬰 嫛
강 이름	강 이름 淇 洛 湳 淶 澧 潞 溧 洺 濮 瀘 沘 淝 淠 泜 濠 滬 淮
강고도리	강고도리 鰹
강과콩고	강과콩고 剛果共和國
강아지풀	강아지풀 稊
강한 쇠	강한 쇠 鉅
개 싸울	개 싸울 吽
개구리밥	개구리밥 萍 蓱
개똥벌레	개똥벌레 螢
개암나무	개암나무 榛
거공벌레	거공벌레 駏
거꾸러질	거꾸러질 倒
거적자리	거적자리 苫
거칠어질	거칠어질 蕪
걸터앉을	걸터앉을 踞 蹲
검은 깨	검은 깨 苣
검은 말	검은 말 驪 驪
검은비단	검은비단 緇
검은칠할	검은칠할 黝
겉치레할	겉치레할 幅
게워내는	게워내는 嘔
겨드랑이	겨드랑이 腋
겨무거리	겨무거리 覈
겨울사냥	겨울사냥 狩
겨울살이	겨울살이 苳
결단내릴	결단내릴 彖
경사로울	경사로울 烋
경쇠걸이	경쇠걸이 栒
곁눈질할	곁눈질할 眄
계수나무	계수나무 桂
계집광대	계집광대 倡
계집아이	계집아이 孃
계집이름	계집이름 姮
고기구을	고기구을 炙
고기구이	고기구이 炙 炙
고깔비녀	고깔비녀 頍
고생살이	고생살이 艱
고슴도치	고슴도치 蝟
고욤나무	고욤나무 桾
고운 옷	고운 옷 袗
고을이름	고을이름 莒 邽 坊 單 陝 葉 鄂 兗 蔚 蔿 渝 褒 馮 杭 濠
고함지를	고함지를 咆
곡식거둘	곡식거둘 穫
곡식심을	곡식심을 稼
곡식익을	곡식익을 稔
곧은 말	곧은 말 讜
골 이름	골 이름 嶰
곱사등이	곱사등이 痀 駝
공액콩고	공액콩고 公額共和國
공잇소리	공잇소리 橐
광랑나무	광랑나무 桄
괘 이름	괘 이름 坎 乾 謙 損 巽 訟 隨 需 升 井 萃 夬 泰 兌 嗑 解
괴로워할	괴로워할 惱 煩
구레나룻	구레나룻 髥
구름 낄	구름 낄 靆
구리동이	구리동이 鏖
구슬이름	구슬이름 瑠
구실이름	구실이름 耡
구약나물	구약나물 蒻
군더더기	군더더기 贅
굵은 베	굵은 베 褐
굼틀거릴	굼틀거릴 蜿 蚴
귀 밝을	귀 밝을 聰
귀뚜라미	귀뚜라미 蛬 莎 蟀 蟋 蜻
귀막이옥	귀막이옥 瑱
귀머거리	귀머거리 聾 聾
귀밑 뼈	귀밑 뼈 顳
귀신이름	귀신이름 矞 融
귀양보낼	귀양보낼 貶
그러모을	그러모을 掊
그러하나	그러하나 扨
그럴듯할	그럴듯할 疑
그렁거릴	그렁거릴 錚
그루터기	그루터기 檮 蘖
그르다할	그르다할 誹
그리워할	그리워할 慕
그림족자	그림족자 挂 幀
글 지을	글 지을 著
글체이름	글체이름 七
금석소리	금석소리 鎗
금옥소리	금옥소리 玲 玲
급히걸을	급히걸을 蹶
기 힘들	기 힘들 軻
기름진흙	기름진흙 壤
기어다닐	기어다닐 爬
기와가마	기와가마 窯
기운성할	기운성할 氤
기울어질	기울어질 傾 側 頹 陂 向
기지개켤	기지개켤 申
길 돋울	길 돋울 埇
길 치울	길 치울 蹕
김 쏘일	김 쏘일 炙
김 오를	김 오를 烝 蟲
깃 일산	깃 일산 翳
깃의 가	깃의 가 褄
깃푸른새	깃푸른새 翠
깊고 멀	깊고 멀 耽
깊고넓을	깊고넓을 汪
깊은 골	깊은 골 嵌
깊은 산	깊은 산 嵌
까끄라기	까끄라기 芒 秒 銳
까다로울	까다로울 苛
까마득할	까마득할 窅
까무라칠	까무라칠 殑
까무러칠	까무러칠 蘇
까불거릴	까불거릴 炰
깜부기불	깜부기불 燼
깨끗이할	깨끗이할 浴
껄끄러울	껄끄러울 濇
껑거리끈	껑거리끈 紂
꼭두서니	꼭두서니 蒐 染
꽃봉오리	꽃봉오리 蕾 蓓 葩 莟
꿈틀거릴	꿈틀거릴 蠢
꿩의 깃	꿩의 깃 翟
끌어 쥘	끌어 쥘 絅
끌어당길	끌어당길 攀
끓는 물	끓는 물 滾
끓어앉을	끓어앉을 跪
끙끙거릴	끙끙거릴 呻 吟
나라동산	나라동산 苑
나라이름	나라이름 莒 佉 郜 檜 郯 隨 莘 姺 鄂 餘 燕 芮 倭 粤 衞 臾 鄣 沮 鄭 蜀 鄒 竺 葡
나랏동산	나랏동산 苑
나무 끝	나무 끝 梶 梢 標
나무그릇	나무그릇 楕
나무껍질	나무껍질 朴
나무딸기	나무딸기 莓
나무바를	나무바를 柾
나무우리	나무우리 寨
나무이름	나무이름 杆 橦 揟 榕 杬 柞 矺
나물이름	나물이름 菲
날 흐릴	날 흐릴 曇 曪
날개치는	날개치는 翛
날다람쥐	날다람쥐 鼯
날따뜻할	날따뜻할 暄
날씨 볼	날씨 볼 占
날카로울	날카로울 利 銳 測
남자무당	남자무당 覡
낭떠러지	낭떠러지 崖
낮은 담	낮은 담 垣
낮은 땅	낮은 땅 塌
내 이름	내 이름 濂 汶 渼
내리다지	내리다지 幱
냄새맡을	냄새맡을 嗅
너그러울	너그러울 寬 鞱 裕 宥 綽 挺 坦 泰
넋 잃을	넋 잃을 褫
널리알릴	널리알릴 佈
넓고 큰	넓고 큰 瀚
넓고 클	넓고 클 蕩
넓은 못	넓은 못 鋲
넓적다리	넓적다리 股 髀 腿
노 저을	노 저을 棹
노래부를	노래부를 唱 唄
노략질할	노략질할 窛 掠 略 掠 剿 鈔
노린내날	노린내날 羶
노송나무	노송나무 栝 檜
노인존칭	노인존칭 爺
노자이름	노자이름 聃
농병아리	농병아리 鷿
높은 산	높은 산 嶽
높이 들	높이 들 揭
뇌물 줄	뇌물 줄 賂
누런 말	누런 말 驃
누른 빛	누른 빛 黅 熉
누에나방	누에나방 蛾
누에나비	누에나비 蛾
누에시렁	누에시렁 槌
눈 감을	눈 감을 瞑 盹
눈 광채	눈 광채 波
눈 흐릴	눈 흐릴 瞙 眊
눈물흐를	눈물흐를 潸
눈부릅뜰	눈부릅뜰 瞋
눈어두울	눈어두울 盲
느름나무	느름나무 楡
느즈러질	느즈러질 緩
느티나무	느티나무 槐 机
늘 돋을	늘 돋을 旽
늘어놓을	늘어놓을 陳
능금나무	능금나무 檎 柰
능수버들	능수버들 檉
다듬잇돌	다듬잇돌 砧
다룬가죽	다룬가죽 靼
다박머리	다박머리 髫
다섯거리	다섯거리 康
다팔머리	다팔머리 髦
단풍나무	단풍나무 槭 楓
달 밝을	달 밝을 晈
닭의 홰	닭의 홰 榤
대 기구	대 기구 籐
대 껍질	대 껍질 篾 籜
대 상자	대 상자 簏
대 이름	대 이름 簟
대 홈통	대 홈통 筧
대거리할	대거리할 讎
대나무통	대나무통 筩
대롱거릴	대롱거릴 攸
대장 기	대장 기 牙
대장장이	대장장이 冶
대지팡이	대지팡이 苴
대추나무	대추나무 棗
대춘나무	대춘나무 椿
더러워질	더러워질 渝
더벅머리	더벅머리 竪 豎
더운 물	더운 물 湄
더워지기	더워지기 蔯
더위잡을	더위잡을 攀
덧방나무	덧방나무 輔
데릴사위	데릴사위 贅
도깨비불	도깨비불 燐 燐
도꼬마리	도꼬마리 笭 苓 枲
도끼바탕	도끼바탕 椹
도리깨채	도리깨채 枷
도장찍을	도장찍을 捺
도토마리	도토마리 樀
독초이름	독초이름 茛
독화당할	독화당할 儵
돈 이름	돈 이름 仄
돋구어낼	돋구어낼 摘
돌 던질	돌 던질 沰
돌 모양	돌 모양 碌
돌 소리	돌 소리 砬
돌무더기	돌무더기 磊 磊 磧
돌아다닐	돌아다닐 涉 循 徼
동근 옥	동근 옥 璧
동자기둥	동자기둥 棟
되돌아올	되돌아올 般 違
두근거를	두근거를 悸
두근거릴	두근거릴 悸
두드러기	두드러기 癮
두런거릴	두런거릴 喞 啾
두렁허리	두렁허리 鱓
두레박줄	두레박줄 綆
두려워할	두려워할 懼 慄 悚 猜 疑 佂 伀 惕 惴 惶 恟
두루마기	두루마기 袍
둘 얻을	둘 얻을 兼
둥근곳집	둥근곳집 囷
둥둥 뜰	둥둥 뜰 沛
뒷걸음칠	뒷걸음칠 逡
들메나무	들메나무 楠
등골 뼈	등골 뼈 膂
등성마루	등성마루 脊
등에 질	등에 질 揭
등자나무	등자나무 橙
따비질할	따비질할 墾
땅 경계	땅 경계 疆
땅 이름	땅 이름 酈 竗 禺 邢
땅강아지	땅강아지 螻
땋은 노	땋은 노 繶
떠들석할	떠들석할 聒
떠들썩할	떠들썩할 噪 哄 譁
떡갈나무	떡갈나무 樫 槲 楥
떡잎 날	떡잎 날 甲
떨어뜨릴	떨어뜨릴 輸 沰
떼 놓을	떼 놓을 離
뙈기 밭	뙈기 밭 畸
뚫린 골	뚫린 골 豁
뛰어넘을	뛰어넘을 超
뜩 막힐	뜩 막힐 腷
띠 뿌리	띠 뿌리 茹
마른 뼈	마른 뼈 骼
마른나무	마른나무 槁
마름질할	마름질할 裁
마을 문	마을 문 閈
마음밝을	마음밝을 愰
마주 들	마주 들 扛
말 굴레	말 굴레 羈 覉
말 그칠	말 그칠 矣 耳 旃
말 끝낼	말 끝낼 羌
말 내킬	말 내킬 粤
말 많을	말 많을 訉
말 부릴	말 부릴 馭
말 우는	말 우는 蕭
말 잘할	말 잘할 截 詖
말 재갈	말 재갈 鑣
말갈나라	말갈나라 鞨
말갈보석	말갈보석 鞨
말거머리	말거머리 螞
말고들개	말고들개 鞦
말굽히할	말굽히할 喇
말다툼할	말다툼할 嚚 齗
말더듬는	말더듬는 吃
말더듬을	말더듬을 吃
말똥구리	말똥구리 鴟
말머무를	말머무를 駐
말미암을	말미암을 由
말오줌대	말오줌대 蒴
말이우는	말이우는 嘶
맑은 술	맑은 술 醍
맑은대쑥	맑은대쑥 薛
맘 급할	맘 급할 怦
맞아들일	맞아들일 訝
매조미쌀	매조미쌀 糙
매화나무	매화나무 枏 梅
머구리밥	머구리밥 萍 蓱
머귀나무	머귀나무 梧
머리 클	머리 클 肦
머리감을	머리감을 沐
머리깍을	머리깍을 剃
머리덜미	머리덜미 脺
머리빗을	머리빗을 梳
머리쓰개	머리쓰개 髲
머리에일	머리에일 戴
머리장식	머리장식 鬘
머리쳐들	머리쳐들 儼
머뭇거릴	머뭇거릴 迍 需 媕 冘 低 躇 邅 躊 踟 躇 躑 儃 跱
멀떠구니	멀떠구니 嗉 膆
멀리보는	멀리보는 瞭
메추라기	메추라기 鶉
면류관술	면류관술 斿
명치 끝	명치 끝 肓
모과나무	모과나무 楙
모래무지	모래무지 鮀
모름지기	모름지기 須
모지라질	모지라질 翛
모진 배	모진 배 杭
모형나무	모형나무 荊
목 잠글	목 잠글 箝
목뻣뻣할	목뻣뻣할 痙
몸 굽힐	몸 굽힐 傛
못 이름	못 이름 瑤 浴
무너뜨릴	무너뜨릴 潰 訌 隳
무서워할	무서워할 怯
무지러질	무지러질 減
묵은 솜	묵은 솜 縕
문 닫을	문 닫을 闋 閟
문 빗장	문 빗장 閘 楗 扊
문드러질	문드러질 爛 爛
문절망둑	문절망둑 鯊
문체이름	문체이름 篆 牋
물 갈래	물 갈래 派
물 건널	물 건널 涉
물 고일	물 고일 澱 渟
물 굽이	물 굽이 汭
물 깊을	물 깊을 囦 奫 泫
물 끓일	물 끓일 湯
물 넓을	물 넓을 瀰
물 넘칠	물 넘칠 滔 濊 涌
물 맑을	물 맑을 粼 瀟 湜 渶 澈
물 번질	물 번질 湔
물 소리	물 소리 濞 淙
물 솟을	물 솟을 滕
물 이름	물 이름 沂 潼 泗 汝 渷 潁 汭 澳 洼 沅 洹 渭 灐
물 잦을	물 잦을 澌
물 젖을	물 젖을 波
물 흐를	물 흐를 沔 盈 潏 泡
물건 맬	물건 맬 攇
물건 살	물건 살 貿
물결 셀	물결 셀 泙
물결 일	물결 일 滎
물결높을	물결높을 潼
물결무늬	물결무늬 渼
물끓는김	물끓는김 汽
물놀이칠	물놀이칠 漣 漪
물살세찰	물살세찰 洶
물속자갈	물속자갈 磯
물어뜯을	물어뜯을 啀
물웅덩이	물웅덩이 瀯
물이 괼	물이 괼 豬
물줄기멀	물줄기멀 灝
물질펀한	물질펀한 漫
미꾸라지	미꾸라지 鰍 鰌
미끄러울	미끄러울 汰 滑
미끄러질	미끄러질 跳 跕 跎 汰 隤
미적거릴	미적거릴 違
미치광이	미치광이 癡 瘋
민족이름	민족이름 獩
밀 국수	밀 국수 饂
밀가루떡	밀가루떡 餠
밉살스럴	밉살스럴 猙
바느질할	바느질할 針
바다이름	바다이름 渤
바다잇수	바다잇수 浬
바람소리	바람소리 颯 蕭 颼 瑟
바로 볼	바로 볼 瞪
바로잡을	바로잡을 矯 董 訂
바른말할	바른말할 謇
바야흐로	바야흐로 剛 鼎
바위구멍	바위구멍 岫
바위너설	바위너설 礧
바퀴굴대	바퀴굴대 軻
바퀴굴데	바퀴굴데 軌
바퀴살통	바퀴살통 輻
박달나무	박달나무 檀 檍
반짝거릴	반짝거릴 耿
발 걷을	발 걷을 褰
발두꿈치	발두꿈치 跟
밥 먹일	밥 먹일 食
밥 지을	밥 지을 炊
방 구들	방 구들 墺
방 붙일	방 붙일 牌
방울소리	방울소리 鎟 鍈
방정맞을	방정맞을 佻
밭 도랑	밭 도랑 畎
밭 두덕	밭 두덕 町
밭 두둑	밭 두둑 堈
밭개간할	밭개간할 畇
배 꼬리	배 꼬리 舳
배 닿을	배 닿을 艤
배 멈출	배 멈출 碇
배불룩할	배불룩할 脹
뱀 이름	뱀 이름 率
버마재비	버마재비 螂
번거로울	번거로울 懣 煩 擾
번쩍거릴	번쩍거릴 燁
벌거벗을	벌거벗을 裸 臝
벌거숭이	벌거숭이 裸 裸
벌그레할	벌그레할 煒
벌레먹을	벌레먹을 蝕
벌레소리	벌레소리 喓
벌레이름	벌레이름 曷 宵 雖 蚩
범 소리	범 소리 闞
범자의만	범자의만 卍
법도있는	법도있는 儺
벗 사귈	벗 사귈 遊
벙긋거릴	벙긋거릴 听
벼 이름	벼 이름 秦
벼 패일	벼 패일 秀
벼메뚜기	벼메뚜기 蚱
벼슬아쳐	벼슬아쳐 寮
벼슬아치	벼슬아치 吏 紳
벼슬이름	벼슬이름 噶 盾 拾 尉 尹 弋 度 嬖 馮 翰 侯
변두리땅	변두리땅 堧
별 이름	별 이름 婁 牛 轅 垣 危 胃
병 고칠	병 고칠 醫
병 나을	병 나을 愈 癒 痊 瘳
병 없을	병 없을 健
볕 쏘일	볕 쏘일 曝
보금자리	보금자리 窠
보름새베	보름새베 緦
보리 팰	보리 팰 蔪
보리나무	보리나무 菩
부끄러울	부끄러울 愧 羞 惡 怍 慙 慚 醜 陬 恥
부드러울	부드러울 懦 巽 順 純 軟 沃 溫 優 柔 融 隤
부들풀싹	부들풀싹 葯
부러워할	부러워할 羨 妒
부르짖을	부르짖을 噭 嘄 叫 籲 龥 號 嚆
부지런할	부지런할 劫 勤 孜 孶 飭
부처이름	부처이름 迦
북 울릴	북 울릴 駭
북두자루	북두자루 杓
북두자리	북두자리 杓
북방축소	북방축소 鏜
북쪽 창	북쪽 창 向
분 바를	분 바를 飾
불 꺼질	불 꺼질 熄
불 놓을	불 놓을 燒
불 붙을	불 붙을 燒
불 성할	불 성할 燉
불 지필	불 지필 炊
불똥 튈	불똥 튈 熛
불린 금	불린 금 鈑
불에 델	불에 델 燙
불에 쬘	불에 쬘 焙
불에말릴	불에말릴 燥
불친 소	불친 소 犍
불친 양	불친 양 羯
붉은 끈	붉은 끈 靺
붉은 빛	붉은 빛 緋 韞
붉은 소	붉은 소 騂
붉은 쇠	붉은 쇠 錕
붉은 옥	붉은 옥 璊
붉은 칠	붉은 칠 彤
비뚤어질	비뚤어질 斜 頗
비자나무	비자나무 榧
비틀거릴	비틀거릴 蹣 媻 逶 酊
비파나무	비파나무 枇 杷
빈랑나무	빈랑나무 檳
빙그레할	빙그레할 逌
빛 고울	빛 고울 媄
빛 변할	빛 변할 渝
빛 환할	빛 환할 暐
빠른 말	빠른 말 騛
뼈 바를	뼈 바를 脫
삐걱거릴	삐걱거릴 轢
사기창고	사기창고 宬
사닥다리	사닥다리 橿
사당나무	사당나무 棠
사람이름	사람이름 弇 鏗 乭 卨 瑥 邕 煨 頊 熤 趎 丑 琸
사로잡을	사로잡을 擒 擄 擄 俘 捕
사진찍을	사진찍을 撮
사타구니	사타구니 胯 胯 枳
사탕수수	사탕수수 蔗
사향노루	사향노루 麝
삭양 빛	삭양 빛 曛
산 높을	산 높을 崛 峨 嶸 嵔 崟 岝 磼 崢
산 언덕	산 언덕 塢
산 이름	산 이름 崍 岭 崙 邙 巫 崤
산 험할	산 험할 嵁
산골짜기	산골짜기 嵌 隍
산길험할	산길험할 嶠 崎
산도깨비	산도깨비 魈
산등성이	산등성이 岡 崗
산무너질	산무너질 崩
산봉우리	산봉우리 巒 峯
산뽕나무	산뽕나무 杆 檿 柘
산우뚝할	산우뚝할 峙
산이높은	산이높은 嶢
산이험한	산이험한 嶸
산초나무	산초나무 椒
산험준할	산험준할 嶇
살갗 틀	살갗 틀 腁
살찐 말	살찐 말 駜
삶은 실	삶은 실 絨
삽주뿌리	삽주뿌리 朮
상서구름	상서구름 矞
상서로울	상서로울 祥 禎
상여수레	상여수레 輰
새 그물	새 그물 羅
새 새끼	새 새끼 鷇 雛
새 소리	새 소리 嚶
새 이름	새 이름 鵩
새 후릴	새 후릴 囮
새살 날	새살 날 膣
새앙머리	새앙머리 妑
생명주실	생명주실 綃
서러워할	서러워할 憖
서른 근	서른 근 鈞
서옥이름	서옥이름 琮
석류나무	석류나무 榴
선웃음칠	선웃음칠 咿
성 윗담	성 윗담 雉
성밑해자	성밑해자 壕
세 바칠	세 바칠 貰
세모진창	세모진창 矛
세발가마	세발가마 錡
세째지지	세째지지 寅
소곤거릴	소곤거릴 聶
소근거릴	소근거릴 呢
소리지를	소리지를 喑
소용돌이	소용돌이 渦
속 끓일	속 끓일 渭
속걱정할	속걱정할 隱
속빈 대	속빈 대 筠
손 씻을	손 씻을 沃
손윗누이	손윗누이 姉
송곳 끝	송곳 끝 穎
송곳질할	송곳질할 矞
쇠몽둥이	쇠몽둥이 椎
쇠북소리	쇠북소리 舂
쇠약해질	쇠약해질 萎
수결 둘	수결 둘 押
수고로울	수고로울 劬 庸 憚
수군거릴	수군거릴 噂
수레고삐	수레고삐 綏
수레바퀴	수레바퀴 輪 收 輪
수레바탕	수레바탕 輿
수레자국	수레자국 轍
수수께끼	수수께끼 謎
수양버들	수양버들 檉
수원앙새	수원앙새 鴛
숙 익을	숙 익을 酋
술 거를	술 거를 釃
술 권할	술 권할 酬
술 따를	술 따를 斟
술 빚을	술 빚을 釀 醞
술 즐길	술 즐길 酖
술 취할	술 취할 酩
술구더기	술구더기 蟻
숨 내쉴	숨 내쉴 呼
숫원앙새	숫원앙새 鴛
숱 많을	숱 많을 鬒
스며흐를	스며흐를 瀷
슬기로울	슬기로울 睿 慧 譿
시끄러울	시끄러울 鬧 嘍 渦 譟 譁
시끄럽다	시끄럽다 囂
시어머니	시어머니 姑
시제지낼	시제지낼 柴
신 신을	신 신을 躡
실 마디	실 마디 纇
심술부릴	심술부릴 術
싱글벙글	싱글벙글 妗
싸라기눈	싸라기눈 霰
싸리나무	싸리나무 檍
싸움수레	싸움수레 戎
싹 트일	싹 트일 坼
쌀 씻을	쌀 씻을 蹂 浙
쌓아올릴	쌓아올릴 陪
쓰다듬을	쓰다듬을 捫
아기사슴	아기사슴 麑
아랫수염	아랫수염 鬚
아름다울	아름다울 佳 嘉 孌 楙 美 韶 秀 阿 衍 嬿 厭 英 嬴 褘 懿 嫥 奕 嫮 徽 烋 嬉
아리따울	아리따울 嬌 娜 娿 沃 婷
아이 밸	아이 밸 胚 身 胎
아주까리	아주까리 蓖
아지랑이	아지랑이 靄
아지랭이	아지랭이 靄
아청통견	아청통견 繰
아홉거리	아홉거리 馗
악기 불	악기 불 吹
악기부릴	악기부릴 彈
악기이름	악기이름 穅 杷
악착같을	악착같을 齷 齪
알랑거릴	알랑거릴 阿
암무지개	암무지개 霓 蜺
암봉황새	암봉황새 凰
암원앙새	암원앙새 鴦
앙금 흙	앙금 흙 涅
앙심먹을	앙심먹을 慊
애오라지	애오라지 聊
앵두나무	앵두나무 櫻
야자나무	야자나무 椰
약 이름	약 이름 莘 蓉
약 지을	약 지을 劑
양치질할	양치질할 漱
어그러질	어그러질 乖 睽 剌 戾 舛 僢
어기어질	어기어질 愆 忒
어깨쭉지	어깨쭉지 髆
어깻죽지	어깻죽지 胛
어렴풋할	어렴풋할 僾 慌
어루러기	어루러기 癜
어루만질	어루만질 撫 憮 捫 敉 拊 按
어르신네	어르신네 椿
어름나무	어름나무 樋
어리석은	어리석은 婁
어리석을	어리석을 憨 倥 戇 呆 暗 闇 騃 獃 庸 愚 嚚 顓 侄 痴 癡 蚩 傝
어린 벼	어린 벼 稚
어린아이	어린아이 雛 孩
어수선할	어수선할 樊 藉 惷 舛
어스레할	어스레할 曨
어정거릴	어정거릴 佯 迤 佪
어지러울	어지러울 滑 攪 亂 亂 紊 哱 龐 紛 繽 搜 惹 暈 悖 溷 滑
억지부릴	억지부릴 愕
언덕머리	언덕머리 埼
언뜻 볼	언뜻 볼 瞥
얼레자루	얼레자루 柅
얼어붙을	얼어붙을 凅
얼어터질	얼어터질 皸
얼음풀릴	얼음풀릴 泮
얼크러질	얼크러질 紜
업신여길	업신여길 嫚 蔑 侮 狎 傲 嫯 愚 蚩
엎드러질	엎드러질 僵 顚 斃 獘 匍
에워 쌀	에워 쌀 圍
여그러질	여그러질 戾
여름하늘	여름하늘 昊
여우모양	여우모양 綏
여자이름	여자이름 媧 嫄
연기 낄	연기 낄 熏 燻
연봉오리	연봉오리 菡
열 사람	열 사람 什
염불소리	염불소리 唄
엿되들이	엿되들이 桶
영화로울	영화로울 榮
예쁜계집	예쁜계집 娃 媛
옛적신인	옛적신인 倧
오그라질	오그라질 縮
오동나무	오동나무 檟 桐 榮 梧
오두막집	오두막집 廬
오래 볼	오래 볼 覨
오래 설	오래 설 佇
오래머물	오래머물 淹
오랜 병	오랜 병 疚
오색비단	오색비단 綵
오지그릇	오지그릇 窯 瓷
옥 광채	옥 광채 霦
옥 소리	옥 소리 瑲 瑝
옥 이름	옥 이름 珂 瓘 琦 琅 珣 珽 珒 珝
옥 쪼을	옥 쪼을 琢
옥같은돌	옥같은돌 琅 瑯
옥광채날	옥광채날 璟
옥덩어리	옥덩어리 璞
옥돌이름	옥돌이름 瑪 珷
옥의 티	옥의 티 玷 瑕
옷 뒤길	옷 뒤길 褒
옷 벗을	옷 벗을 褪
옷 터질	옷 터질 綻
옷 해질	옷 해질 鶉 敝
옷긴모양	옷긴모양 袁
옷벗어멜	옷벗어멜 袒
왕대나무	왕대나무 篔
외발짐승	외발짐승 夔
요괴로울	요괴로울 妖
용솟음할	용솟음할 浤 湓
우기나무	우기나무 玗
우는소리	우는소리 吼
우뚝 설	우뚝 설 踔
우러러볼	우러러볼 仰
우물거릴	우물거릴 蟄
우물난간	우물난간 幹
우물도랑	우물도랑 澮
우물벌레	우물벌레 蹶
울부짖을	울부짖을 嘶 號 虓
울타리칠	울타리칠 砦
움 돋을	움 돋을 孫
움추러질	움추러질 蜷
움켜 뜰	움켜 뜰 匊
웃는모양	웃는모양 謚
웅덩이물	웅덩이물 洵
웅얼거릴	웅얼거릴 梵
위대로울	위대로울 醯
윤택할금	윤택할금 銑
으스스할	으스스할 漂
은 바리	은 바리 盌
의심쩍을	의심쩍을 焉
이 빠질	이 빠질 缺 齫
이를 갈	이를 갈 齠
이바지할	이바지할 供 億
이지러질	이지러질 騫 缺 窳 虧
일 없을	일 없을 妥
일찍죽을	일찍죽을 殤
잃어버릴	잃어버릴 遺 奪
입 다물	입 다물 鉗 噤 唫 囁 嗑
입 벌릴	입 벌릴 叭 呀
잊어버릴	잊어버릴 悗
자갈 땅	자갈 땅 墝
자드락길	자드락길 墱
자작나무	자작나무 椴 樺
작은 관	작은 관 槥
작은 배	작은 배 艀 葦 艇
작은 범	작은 범 彪
작은 성	작은 성 壔 堡 墉
작은 잔	작은 잔 坎
작은 징	작은 징 鐃
작은 통	작은 통 笭
작은구슬	작은구슬 璣
잘름거릴	잘름거릴 痿
잠꼬대할	잠꼬대할 魘 囈
잡색비단	잡색비단 紐
잡아가둘	잡아가둘 逮
잡아다릴	잡아다릴 擥
잡아당길	잡아당길 挹
장가들다	장가들다 娉
장구벌레	장구벌레 蛣
장사지낼	장사지낼 襄
재두루미	재두루미 鴰
재잘거릴	재잘거릴 喃 喋
저 이름	저 이름 篪
저녁조수	저녁조수 汐
저민고기	저민고기 臠
저울질할	저울질할 銓 稱
전별잔치	전별잔치 餞
절뚝발이	절뚝발이 蹇 跛
절름거릴	절름거릴 蹇 逴
절름발이	절름발이 尫 跛
젊은계집	젊은계집 娘
점잔피울	점잔피울 佖
젓 담글	젓 담글 醢
정성스럴	정성스럴 切
정성없는	정성없는 僿
제비뽑을	제비뽑을 鬮
제사지낼	제사지낼 禋 享
조그마할	조그마할 稗
조막손이	조막손이 杻
조화로울	조화로울 燮 雍 雝
좀스러울	좀스러울 瑣
좁은 길	좁은 길 奪
종려나무	종려나무 櫚 棕
종묘제기	종묘제기 璉
종족이름	종족이름 閩
죄 사할	죄 사할 宥
죄 없을	죄 없을 寃
죄를캐물	죄를캐물 劾
중얼거릴	중얼거릴 囁 謷
쥐똥나무	쥐똥나무 楨
쥐며느리	쥐며느리 蟠
쥐부스럼	쥐부스럼 疙
즐기어할	즐기어할 肯
지느러미	지느러미 鰭
지푸라기	지푸라기 芥
진 이름	진 이름 甄
진눈깨비	진눈깨비 霄
질 그도	질 그도 陶
짐 실을	짐 실을 馱
짐승먹이	짐승먹이 芻
짐승소리	짐승소리 咆
짐승이름	짐승이름 犍 駮 窳 猙 騶 橐 狴
집 쏠릴	집 쏠릴 廢
집 울릴	집 울릴 宖
집 지을	집 지을 巢
집비둘기	집비둘기 鵓
징검다리	징검다리 矼
짝 맞을	짝 맞을 耦
쪼아먹을	쪼아먹을 唼
쭈그러질	쭈그러질 皺 蹙
찍찍거릴	찍찍거릴 啾
차의 싹	차의 싹 茗
참죽나무	참죽나무 橿 檍 椿
창갈구리	창갈구리 孑
찾아가다	찾아가다 聘
채색무늬	채색무늬 絢
채색빛날	채색빛날 澔
채소이름	채소이름 巢
책 상자	책 상자 笧
책 펴낼	책 펴낼 刊
책메뚜기	책메뚜기 檢
천둥소리	천둥소리 殷
천한사람	천한사람 褐
첩의자식	첩의자식 孼
첫 생일	첫 생일 晬
청부루말	청부루말 騅
치자나무	치자나무 薝
침 뱉을	침 뱉을 咳
침 삼킬	침 삼킬 嚥
칼 담글	칼 담글 淬
칼 이름	칼 이름 鏌
코 베일	코 베일 劓
코밑수염	코밑수염 髭 頿
큰 가마	큰 가마 鍗
큰 대포	큰 대포 砲
큰 두덕	큰 두덕 墟
큰 머리	큰 머리 頒
큰 모양	큰 모양 昊
큰 물결	큰 물결 澐
큰 바다	큰 바다 洋 瀛
큰 바람	큰 바람 苑
큰 방패	큰 방패 櫓
큰 보습	큰 보습 鈐
큰 생황	큰 생황 竽
큰 서옥	큰 서옥 玠
큰 소리	큰 소리 訇 砏
큰 쇠북	큰 쇠북 鏞
큰 언덕	큰 언덕 陵
큰 자라	큰 자라 鰲 黿
큰 조개	큰 조개 蜃
큰 창자	큰 창자 胴
큰 피리	큰 피리 巢
큰고라니	큰고라니 麂
킬로그램	킬로그램 瓩
타달거릴	타달거릴 踽
탐스러울	탐스러울 嬅
태평세월	태평세월 昭
탱자나무	탱자나무 枳
토끼그물	토끼그물 畢 罼
토막나무	토막나무 梡
투호 살	투호 살 籌
파 뿌리	파 뿌리 蔥
패랭이꽃	패랭이꽃 蘧
패려궂을	패려궂을 很
패옥소리	패옥소리 瑢 瑽
퍼주거릴	퍼주거릴 抖
펄렁거릴	펄렁거릴 颭
푸른 대	푸른 대 靛
푸른 빛	푸른 빛 碌
푸른인끈	푸른인끈 綸
푸조나무	푸조나무 梁
풀 깎을	풀 깎을 薙
풀 이름	풀 이름 芩 蘄 范 莩 芘 荀 莚 萎
풍류가락	풍류가락 詩
풍류그릇	풍류그릇 釪
풍류그칠	풍류그칠 敔
풍류이름	풍류이름 韺 板 頀
하고자할	하고자할 欲 慾 願
하눌타리	하눌타리 筈
하루거리	하루거리 痎
하루살이	하루살이 蜉 蝤
하소연할	하소연할 訴 遡
한 가지	한 가지 皆
한 모금	한 모금 哈
한발자국	한발자국 跬
한숨 쉴	한숨 쉴 愾 歔
할아버지	할아버지 王 祖
합사비단	합사비단 縑
합환주잔	합환주잔 卺
해 돋을	해 돋을 昇 暘 旴
해 비칠	해 비칠 曜
해 이름	해 이름 灘
해가 질	해가 질 舂
해그림자	해그림자 晷
해바라기	해바라기 葵
해오라기	해오라기 鷺 鷺
햇살오를	햇살오를 暹
행주치마	행주치마 襜
향기로울	향기로울 芬 馣 馨
향초이름	향초이름 挺
허둥거릴	허둥거릴 遑
허수아비	허수아비 塑
헐떡거릴	헐떡거릴 喘
헛소리할	헛소리할 囈
헝클어질	헝클어질 鬖
호미자루	호미자루 橿 楏
호수이름	호수이름 蜆
화기로울	화기로울 藹
화끈거릴	화끈거릴 炘
환히밝을	환히밝을 煌
활 깍지	활 깍지 玦
활 부릴	활 부릴 弛
황경나무	황경나무 蘗
황백나무	황백나무 檗
황벽나무	황벽나무 檗
회리바람	회리바람 飄
훌부들할	훌부들할 韋
훌쩍 날	훌쩍 날 翩 票 縹
휘늘어진	휘늘어진 朶
휘뚝거릴	휘뚝거릴 錡
휘청거릴	휘청거릴 娜
흐트러질	흐트러질 靡
흔들거릴	흔들거릴 捎
흘끗 볼	흘끗 볼 睇
흙 이길	흙 이길 埴 埴
흙덩어리	흙덩어리 塊
흙무더기	흙무더기 堆
흙파올릴	흙파올릴 捄
흰 기운	흰 기운 碭
흰 모양	흰 모양 皜
흰 비단	흰 비단 紈
흰 비름	흰 비름 荑
힘 입을	힘 입을 賴
가까울	가까울 剴 逕 近 駙 侍 爾 邇 側 逼 偪 夾
가난할	가난할 儉 貧
가냘플	가냘플 嘒
가는대	가는대 簇
가늠할	가늠할 藝
가득찰	가득찰 充
가득할	가득할 旬 臆 盈 嬴 載 佖
가라말	가라말 驪
가라지	가라지 莠
가랑비	가랑비 霎
가려울	가려울 痒 癢
가련할	가련할 憐 憐
가로되	가로되 曰 爰
가르칠	가르칠 誥 敎 唆 譔 示 誘 誨 斅 訓
가르침	가르침 敎
가리울	가리울 蓋 曀 蔽
가릴할	가릴할 掏
가마니	가마니 俵
가마솥	가마솥 鼐
가막을	가막을 闌
가물치	가물치 鱧
가벼울	가벼울 減 輕 侻 嫖
가슴칠	가슴칠 擗
가여울	가여울 哀
가운데	가운데 極 央 殷 中 樞 衷
가자미	가자미 鰈 鮃
가장귀	가장귀 丫
가죽신	가죽신 鞋
가죽테	가죽테 鞏
가파를	가파를 嵂 嶙 嵓 崢 埈 巉 峭
간교할	간교할 狡 獪 獪
간략할	간략할 略 略 粗 脫 侻
간사할	간사할 姦 奸 詭 邪 憸 他 侻 慝 詖 譎
간소할	간소할 約
간악할	간악할 奸 讒 慝
간여할	간여할 參
간음할	간음할 淫 通
간절할	간절할 懇 剴 慇
갈고리	갈고리 鉅
갈구리	갈구리 鉅 鉤
갈대청	갈대청 莩
갈라질	갈라질 破
갈래질	갈래질 俣
갈림길	갈림길 衢 岐 岔
갈마들	갈마들 番 迭 遞
갈매기	갈매기 鷗 鷖
갈비대	갈비대 肋
갈빗대	갈빗대 脅
갈이틀	갈이틀 鏇
감독할	감독할 督
감동할	감동할 感 格
감질병	감질병 疳
감창할	감창할 惻
갑자기	갑자기 儵 俄 猝
값 쌀	값 쌀 低
값/성	값/성 賈 賈
강개할	강개할 慷 忼 慨
강구할	강구할 講
강론할	강론할 講
강리풀	강리풀 茳
강샘할	강샘할 妒
강신제	강신제 祼
강이름	강이름 洛 磻 磻 湘 瀟 淞 瀼 潁 瀷 漳
강인할	강인할 忞 忟
강직할	강직할 侃 伉
강화할	강화할 講
개간할	개간할 墾
개구리	개구리 蟇 蛙 蝦
개밋둑	개밋둑 垤
개버들	개버들 蒲
개여뀌	개여뀌 蘢
갯고랑	갯고랑 浜
갯버들	갯버들 楊
거느릴	거느릴 監 領 部 屬 率 御 以 總 摠 統
거동길	거동길 馳
거듭할	거듭할 改 荐
거룻배	거룻배 躉 艇 艚 扁 艑
거리낄	거리낄 槪 牽 妨 偓
거만할	거만할 倨 傑 慢 傲 敖 慠 謷 怠
거머리	거머리 蛭
거문고	거문고 琴 瑟
거미알	거미알 蛸
거스를	거스를 遡 逆 悖
거스릴	거스릴 忤 捂
거슬릴	거슬릴 悖
거여목	거여목 苜
거짓말	거짓말 訛
거친풀	거친풀 蕪
거푸집	거푸집 鎔 熔 型
걱정할	걱정할 欿
건목칠	건목칠 儱
건장할	건장할 佶
건져낼	건져낼 撈
검붉을	검붉을 紫 玄
검사할	검사할 檢
검소할	검소할 儉
검푸를	검푸를 黝
겁박할	겁박할 剽 勡
겁탈할	겁탈할 劫 刦 勡
겉곡식	겉곡식 粟
게시판	게시판 榜
게으를	게으를 倦 懶 懶 懶 嬾 慢 厭 慵 易 惰 怠 懈
격자창	격자창 欞
견전제	견전제 遣
결단할	결단할 決 彖 裁 夬 弊
겸손할	겸손할 謙 遜
겸양할	겸양할 退
겹사돈	겹사돈 媾
경계할	경계할 鑑 警 儆 戒 誡 肅 箴 蕆 敕
경박할	경박할 翾
경쟁할	경쟁할 戰
곁가지	곁가지 肄
계명주	계명주 酤
계속할	계속할 源
계약할	계약할 契 契
계집종	계집종 娭
계획할	계획할 企
고깃점	고깃점 胾
고달플	고달플 儜 憊
고라니	고라니 麏
고루할	고루할 囿
고무래	고무래 耰 丁
고사리	고사리 蕨
고소할	고소할 皀
고시할	고시할 憲
고양이	고양이 猫
고요할	고요할 闃 憺 覃 默 嘿 謐 愼 窈 寂 定 靜 怗 沈 玄
고용할	고용할 僦
고질병	고질병 痼 癈
고집할	고집할 愎
고함칠	고함칠 喊
곡진할	곡진할 繾
곤란할	곤란할 隕
곤룡포	곤룡포 袞
곤륜산	곤륜산 崐
곧은말	곧은말 諰
곧은목	곧은목 頡
골목길	골목길 墉 甬 埇
골짜기	골짜기 谷 壑 豁
곰방메	곰방메 耰
곰팡이	곰팡이 黴
공갈할	공갈할 沮
공경할	공경할 恪 虔 敬 憼 誠 率 竦 肅 崇 嚴 儼 業 聳 悌 祗 欽
공교할	공교할 巧 倆
공근할	공근할 憖
공변될	공변될 公
공손할	공손할 恭 龔 俅 愭 遬 肅 油 兪 慇 揖
공순할	공순할 恭
공허할	공허할 廖
과격할	과격할 檄
과장풀	과장풀 蔣
관이름	관이름 阮 阮
관찰할	관찰할 撿
관철할	관철할 徹
괄태충	괄태충 蛞
광대뼈	광대뼈 顴 肫
광저기	광저기 豇
광주리	광주리 筐
괘이름	괘이름 艮 爻
괴로울	괴로울 苦 困
괴이할	괴이할 傀 異
교만할	교만할 蹇 驕 憍 旭 姐
교묘할	교묘할 巧
교정할	교정할 檢
교청새	교청새 鶄
교활할	교활할 狡 獪 猾 獪
구거리	구거리 逵
구걸할	구걸할 乞
구경할	구경할 翫
구관조	구관조 鸜
구기자	구기자 枸 杞
구더기	구더기 蛆
구덩이	구덩이 坎 埳 坑 穽 塹
구름낀	구름낀 曇
구름낄	구름낄 靉
구리때	구리때 芷 茝
구박할	구박할 毆
구별할	구별할 件
구부릴	구부릴 傴 跼 僂 俯
구속할	구속할 撿 刦 覉
구원할	구원할 救 援
구진매	구진매 鸇
구차할	구차할 屑 偸
구태여	구태여 敢
구푸릴	구푸릴 俯
구휼할	구휼할 賑 恤
군색할	군색할 窘
굽어볼	굽어볼 瞰
궁구할	궁구할 推
궁궁이	궁궁이 芎 芸
궁리할	궁리할 究
궁핍할	궁핍할 逼
권장할	권장할 務
궤란할	궤란할 醉
궤휼할	궤휼할 矞
귀 울	귀 울 聊
귀고리	귀고리 璫 琇 鍝 珥
귀막이	귀막이 琇
귀맑을	귀맑을 聰
귀먹을	귀먹을 聳
귀목풀	귀목풀 苻
귀양갈	귀양갈 譴 謫
귤나무	귤나무 橘
그러나	그러나 然
그러할	그러할 然 兪
그런가	그런가 哉
그령풀	그령풀 苞
그르칠	그르칠 詿 失 脫
그릇될	그릇될 謬
그릇할	그릇할 誤
그림쇠	그림쇠 規
그림자	그림자 影
그슬릴	그슬릴 煨 焦 炮
그윽할	그윽할 幽
그을음	그을음 煤
극진할	극진할 藝 致
근심할	근심할 惸 慱 忉 愍 悁 悠 悒 懆 慽 惙 悄 忡 奕 恤 悴
근싱할	근싱할 焭
글귀절	글귀절 句 勾
글씨판	글씨판 牒
글잘쓸	글잘쓸 敾
글지을	글지을 撰
금제할	금제할 檢
금조개	금조개 蚌
급박할	급박할 絿
기꺼울	기꺼울 懌 說 謜 夷
기다릴	기다릴 待 俟 竢 守 須 需 要 佇 徯
기대다	기대다 憑 凭
기도할	기도할 祈 禳
기러기	기러기 雁 鴈
기록할	기록할 記 錄 錄 攝 箋 誌 編
기롱할	기롱할 評
기름질	기름질 滂 沃
기미낄	기미낄 黴
기뻐할	기뻐할 慆 忭 悅 愉 娧 憲 歡 驩 懽 欣 忻 喜 訢 憙
기숙사	기숙사 塾
기식할	기식할 餬
기약할	기약할 期 約 許
기억할	기억할 憶
기우제	기우제 雩
기울기	기울기 攲
기이할	기이할 怪 奇 畸
기인할	기인할 掾 原
기지개	기지개 伸
기침할	기침할 喀 嗽 欬
기특할	기특할 偉
긴 귀	긴 귀 聕
긴 대	긴 대 箎
긴 창	긴 창 錟
긴요할	긴요할 樞
길 곁	길 곁 匽
길 맬	길 맬 耘
길거할	길거할 据 拮
길귀신	길귀신 行
길드릴	길드릴 馴 擾
길들일	길들일 馴 擾
길쌈할	길쌈할 絍
깃드릴	깃드릴 栖 捿
깃들일	깃들일 栖 捿
깊숙할	깊숙할 邃 穾
깊은산	깊은산 岺
까마귀	까마귀 烏
까부를	까부를 簸
깍지낄	깍지낄 揖 叉
깔깔할	깔깔할 澁
깨끗할	깨끗할 瑳 皓
깨달을	깨달을 覺 感 憬 醒 惺 悟 寤 咀 適 寭
깨뜨릴	깨뜨릴 撼 破 捌
깨어날	깨어날 蘇 甦
깨어질	깨어질 缺 敗
깨우칠	깨우칠 憬 泠 悟 喩 斅
꺠우칠	꺠우칠 解
꼬리별	꼬리별 彗
꼬장할	꼬장할 剛
꼭대기	꼭대기 頂
꼿꼿할	꼿꼿할 梃
꽁무니	꽁무니 尻
꽃다울	꽃다울 芳 榮
꽃받침	꽃받침 萼
꽃부리	꽃부리 英
꾀꼬리	꾀꼬리 鶯 鷪
꾸러미	꾸러미 苴 苞
꾸러피	꾸러피 苞
꾸짖을	꾸짖을 呵 訶 喝 譴 詬 咄 訟 訊 詆 謫 嗔 叱 責 誚 譙 咤 討 嚇
꿈 깰	꿈 깰 醒
꿋꿋할	꿋꿋할 彊
꿩 포	꿩 포 腒
끄어낼	끄어낼 抒
끈끈이	끈끈이 黐
끈끈할	끈끈할 粘 糊
끊어질	끊어질 殊 殄 縣
끝없을	끝없을 泱
나그네	나그네 客 羇 旅
나란할	나란할 倂
나룻배	나룻배 艅
나른할	나른할 殢 疲 歇
나막신	나막신 屐
나머지	나머지 强 殘 孑
나무랄	나무랄 譏 謗
나무못	나무못 栓
나무싹	나무싹 芚
나무좀	나무좀 蛀
나무창	나무창 槍
나무할	나무할 蘇 蕘
나무활	나무활 弧
나물밭	나물밭 圃
나물죽	나물죽 糝
나뭇배	나뭇배 艅
나부낄	나부낄 飄
나아갈	나아갈 赴 遂 藎 詣 酉 揖 迪 進 晉 晋 陟 就 向 許 趐
나약할	나약할 懦
나장이	나장이 儒
나타날	나타날 著 綻 暴 被 見 現 顯 皛
낚시줄	낚시줄 緡 緍 湣
낚싯줄	낚싯줄 綸
난나무	난나무 欒
난산할	난산할 坼
난장이	난장이 矮 僥 侏
난쟁이	난쟁이 侏
날고기	날고기 腥
날라리	날라리 笛
날씬할	날씬할 嬥
날짐승	날짐승 禽
남루할	남루할 褸
납가새	납가새 茨 蒺
내이름	내이름 瀁
너스레	너스레 樔 槌
넉넉할	넉넉할 給 贍 厭 優 偉 裕 賑 最 沛
널기와	널기와 板
널조각	널조각 板
널평상	널평상 楪
넓고클	넓고클 瀚
넘어질	넘어질 倒 躓 跌 蹉
네가래	네가래 蘋
네거리	네거리 衢 辻
네모질	네모질 楞
노구솥	노구솥 鍋 鋗
노나무	노나무 樟 梓 楸
노둔할	노둔할 魯 魯
노래기	노래기 蚰
노래할	노래할 咏 吟
노려볼	노려볼 眈
노력할	노력할 懋
노리개	노리개 瑋 珵 珮 珩
녹나무	녹나무 楠 枏 樟
놀래킬	놀래킬 怖
뇌물줄	뇌물줄 賂
뇌양이	뇌양이 藺 藺
누더기	누더기 襤 襤
누른말	누른말 騂
눈동자	눈동자 瞳 眸 睛
눈시울	눈시울 瞼
눈자위	눈자위 盼
눈짓할	눈짓할 眴
눈흘길	눈흘길 睚
뉘우칠	뉘우칠 懺 悔
느른할	느른할 癃 疲
느슨할	느슨할 紓
느타리	느타리 栮
늘어질	늘어질 縱
늙은이	늙은이 耉 耆 老 老 耄 翁
능가할	능가할 凌 凌
능소화	능소화 苕
능토풀	능토풀 苕
늦어질	늦어질 停
다가설	다가설 遒
다다를	다다를 拒 屆 莅 涖
다닥칠	다닥칠 拒
다달을	다달을 抵
다듬을	다듬을 拭 治
다라울	다라울 鄙
다락집	다락집 閣
다리미	다리미 鈷 熨
다북쑥	다북쑥 蒿
다스릴	다스릴 略 撩 理 釐 撥 繩 諟 伸 訊 養 營 乂 爲 尹 誼 易 宰 爭 靖 治 敕 討 平 轄
다음날	다음날 翌
다죽일	다죽일 殲
다행할	다행할 祐 幸
닥나무	닥나무 楮
단나무	단나무 束
단너삼	단너삼 芪
단단할	단단할 硬
단련할	단련할 冶
단명할	단명할 殀
단자리	단자리 氈
단장할	단장할 粧 靚
단정할	단정할 兗 婐 井
달 뜰	달 뜰 朣
달리다	달리다 騁
달밝을	달밝을 皎
달아날	달아날 逃 遁 遯 迸 北 奔 犇 挻 逸 跌 趨 播 逋
달팽이	달팽이 蝸
닭 울	닭 울 嘐
담벽풀	담벽풀 蓂
담자리	담자리 毯
담쟁이	담쟁이 蔦
담황색	담황색 緗
답답할	답답할 邑 悒 伊 傝 腷
당나라	당나라 唐
당동할	당동할 搪
대 홈	대 홈 樋
대그릇	대그릇 籠 籠
대껍질	대껍질 筠
대답할	대답할 諾 對 諾 兪 應 合
대마디	대마디 節
대머리	대머리 禿 頹
대범할	대범할 倜
대붕새	대붕새 鵬
대상자	대상자 匪
대신할	대신할 代 於 替
대이을	대이을 嗣
대자리	대자리 籧 筵
대장기	대장기 麾
대적할	대적할 格 敵
대접할	대접할 遇 接
대제기	대제기 簋
대줄기	대줄기 竿
대평수	대평수 觱
더듬을	더듬을 搜 試 探
더러울	더러울 垢 黷 鄙 渫 褻 腥 速 穢 薉 汚 猥 渨 點 濁 慝
더럽힐	더럽힐 忝
더북할	더북할 蕤
더불어	더불어 與
덧없을	덧없을 苒
도가니	도가니 坩 堝 橐
도금할	도금할 鍍
도깨비	도깨비 魎 魑 魍 魅
도둑굴	도둑굴 巢
도라지	도라지 桔
도롱이	도롱이 蓑
도룡뇽	도룡뇽 蛟
도르래	도르래 轆
도리깨	도리깨 耞
도리어	도리어 覆
도리옥	도리옥 瑄 瑗
도마뱀	도마뱀 蜥 蠑 蜴
도망갈	도망갈 逋
도망할	도망할 遜 出
도서실	도서실 宬
도지개	도지개 檠 棐 弼
도타울	도타울 篤 敦 惇
도토리	도토리 橡 杼
독수리	독수리 雕 鷲
돌기둥	돌기둥 碑
돌다리	돌다리 矼 磴
돌모양	돌모양 碌
돌소리	돌소리 硜
돌쇠뇌	돌쇠뇌 砲 鉷
돌아갈	돌아갈 降 云
돌아볼	돌아볼 顧 眷 盻
돌아올	돌아올 歸 返 復 復 還 回 廻
돌이킬	돌이킬 反 返
돌파할	돌파할 衝
돗바늘	돗바늘 鉥
돗총이	돗총이 駽
동경할	동경할 憧
동아줄	동아줄 索 索
되질할	되질할 料
두 번	두 번 再
두갈래	두갈래 叉
두견새	두견새 鵑
두꺼비	두꺼비 蟾 鼀 蛤
두더쥐	두더쥐 鼸 鼴
두더지	두더지 鼢
두드릴	두드릴 叩 敲 捆 扣 撞 搯 搏
두렁길	두렁길 畛
두레박	두레박 槹 罐 鑵 缾
두려울	두려울 遽 恐 慄 懾 悚 竦 臣 畏 威 慴 怕 怖 惶
두루미	두루미 鶖 鶴
두루할	두루할 旬
두터울	두터울 篤 惇 醇 渥 腆 厚
둘러쌀	둘러쌀 兜
둘러칠	둘러칠 掟
둥근옥	둥근옥 璧 瑄
뒤따를	뒤따를 迹 扈
뒤섞일	뒤섞일 遝 淆
뒤집힐	뒤집힐 覆
드높일	드높일 揚
드디어	드디어 聿 叵
드러날	드러날 暴 見
드러낼	드러낼 陽 呈
드리울	드리울 垂
든든할	든든할 迤
들나비	들나비 蝶
들날릴	들날릴 揚
들머리	들머리 葡
들쳐낼	들쳐낼 觖
등나라	등나라 鄧
등나무	등나무 藤
등심초	등심초 芯
따뜻할	따뜻할 暖 煖 炆 溫 暄 煊
따비밭	따비밭 菑
딱딱할	딱딱할 倔
땅귀신	땅귀신 媪
땅이름	땅이름 乫 羯 噶 鬲 串 鄲 亳 邵 松 若 倻 鄢 鄴 郢 鄞 郴 陀 涿 隤 巴 鄱 彭 吠 郃 弦
땅지네	땅지네 蚰
때까치	때까치 鴃
땔나무	땔나무 薪 樵 櫬
땜질할	땜질할 錮
땡땡이	땡땡이 鼗
떠받칠	떠받칠 拄
떨어질	떨어질 降 去 距 落 落 零 隕 殞 霣 墜 阤 妥 沰 墮 蘀 塌 貶 廢 飄 降
떳떳할	떳떳할 庸 彛 彝
또아리	또아리 籔
똑똑할	똑똑할 悧 俐 惺
똥구멍	똥구멍 肛
똥오줌	똥오줌 便
뛰어날	뛰어날 傑 卓 逴 特
뜨거울	뜨거울 熱 煦
뜻밖에	뜻밖에 遇 偶
띠매듭	띠매듭 襘
마감할	마감할 勘
마구간	마구간 廐
마디충	마디충 螟
마땅할	마땅할 當 允 宜 該
마룻대	마룻대 涷 桴 棼
마름풀	마름풀 荇
마상북	마상북 鼙
마을문	마을문 閎
마음속	마음속 髓 情 肺
마주들	마주들 舁
마주볼	마주볼 對
마중할	마중할 迓
마침내	마침내 遂 聿
마파람	마파람 凱
막걸리	막걸리 醪
막대기	막대기 桿
만연할	만연할 莚
만족할	만족할 厭 于
맏.형	맏.형 昆
맏누이	맏누이 姐
맏아들	맏아들 胤 嫡
말 울	말 울 嘶
말고삐	말고삐 紂
말구유	말구유 櫪
말달릴	말달릴 騃
말매미	말매미 蜺
말씀할	말씀할 譚
말이름	말이름 騄
말이을	말이을 而
말잘할	말잘할 辯
말전할	말전할 詵
맑은물	맑은물 窪
맛 볼	맛 볼 呫
맛있을	맛있을 旨
망 볼	망 볼 哨
망령될	망령될 妄
망아지	망아지 駒
맞갖을	맞갖을 適
맞이할	맞이할 遡 俉 邀
맡아볼	맡아볼 轄
매가리	매가리 鯆
매달릴	매달릴 縣
매질할	매질할 撻
맥질할	맥질할 墍
맹꽁이	맹꽁이 黽
맹세할	맹세할 盟 誓 約
머금을	머금을 含 啣
머리뼈	머리뼈 顱
머리헐	머리헐 瘍
머릿골	머릿골 腦
머무를	머무를 稽 逗 留 遛 泊 停 住 駐
머슴꾼	머슴꾼 佃
먼동틀	먼동틀 旽 昧
멀리갈	멀리갈 邁
멀리볼	멀리볼 眺
멋대로	멋대로 擅
멍에채	멍에채 轅
메기장	메기장 稷
메까치	메까치 鷽
메뚜기	메뚜기 蛩 蝗
메마를	메마를 埆
멧돼지	멧돼지 豨
멧부리	멧부리 崟
며느리	며느리 婦 媳
면류관	면류관 冕
멸망할	멸망할 滅
멸시할	멸시할 少
명아주	명아주 萊
모독할	모독할 衊
모래벌	모래벌 磧
모래섬	모래섬 陼 坻
모래톱	모래톱 淵 沚
모손할	모손할 衰
모시풀	모시풀 莒
모자랄	모자랄 縮 乏
모종낼	모종낼 蒔
모퉁이	모퉁이 隅
목 맬	목 맬 縊 縊
목 멜	목 멜 咽 噎 嗢
목 벨	목 벨 剄 刎
목 쉴	목 쉴 繭 嘶 喝 喑
목 혹	목 혹 癭
목구멍	목구멍 嚥 臙 咽 噲 喉
목덜미	목덜미 項
목마를	목마를 渴
목사슬	목사슬 鉗
목수건	목수건 裱
목욕할	목욕할 浴
목투구	목투구 鍜
몰려들	몰려들 輳
몰아갈	몰아갈 驟 嘌
못생길	못생길 茸 寢
못이름	못이름 洟 豬
몽둥이	몽둥이 棍 棒 槌
무거울	무거울 重
무고할	무고할 誣
무궁화	무궁화 槿 舜 蕣
무너질	무너질 壞 儡 崩 圮 危 沮 頹 隤 敗 敝 訌
무더울	무더울 溽
무덤길	무덤길 隧
무릅쓸	무릅쓸 冒
무서울	무서울 懾
무성할	무성할 戊 茂 楙 夭 彧 鬱 茲
무안할	무안할 靦
무역할	무역할 貿 贖
무지개	무지개 蝀 雩 虹
무지할	무지할 侗
무찌를	무찌를 鏖
묵묵할	묵묵할 默
묵형할	묵형할 黥
문고리	문고리 鋪
문서함	문서함 缿
문설주	문설주 閣 楔 椄 棖
문신할	문신할 黵
문지기	문지기 閽
문지를	문지를 揩 抆 刷 擦
문지방	문지방 楗 梱 閫 臬 閾
문채날	문채날 斌 飾 郁 彧
물 가	물 가 湄
물 괼	물 괼 瀦
물 댈	물 댈 漑 灌 滴
물 문	물 문 閘
물가닥	물가닥 派
물거품	물거품 漚 涪 漬 泡
물고기	물고기 魚 娵
물굽이	물굽이 灣
물길을	물길을 汲
물깊을	물깊을 泓
물끓을	물끓을 潗
물넘칠	물넘칠 沓 氾
물놀이	물놀이 漣 淪 渼
물도랑	물도랑 庸
물동이	물동이 罐
물들일	물들일 淬 染
물들일	물들일 焠
물러갈	물러갈 綏 逡 縮 出 退
물리칠	물리칠 却 祛 排 擯 攘 擠 斥 逐 黜 拓 退
물맑을	물맑을 潾 瀅
물모양	물모양 淡
물모일	물모일 湊
물방울	물방울 沫 滴
물뿌릴	물뿌릴 淋 汛
물성할	물성할 渙
물소리	물소리 湃 瀯 湲 溵 澎 泙 洶
물솟을	물솟을 洸 湧 涌
물수리	물수리 鶚
물아지	물아지 鯆
물어줄	물어줄 賠
물여뀌	물여뀌 薔
물오리	물오리 鳧
물요괴	물요괴 嬰
물이름	물이름 減 決 淇 湳 潞 汨 汶 潘 汾 湘 灄 沁 洧 泑 溵 圁 澶 浙 湞 淄 漆 濁 涿 湯 灞 浿 淮
물이샐	물이샐 洩
물장군	물장군 甕
물적실	물적실 渲
물총새	물총새 翡
물흐를	물흐를 淘
미나리	미나리 芹
미련할	미련할 憨 魯 癡
미워할	미워할 厭 惡 忤 齗 憎 嫉 妒
미천할	미천할 側
미치다	미치다 隶
미친개	미친개 猘
미혹할	미혹할 迷 惑
민둥산	민둥산 屺
민첩할	민첩할 敏 聰
밀가루	밀가루 麵 麪
밀기울	밀기울 麩
밑바닥	밑바닥 礑
바가지	바가지 匏
바구니	바구니 籃
바구미	바구미 强
바둑둘	바둑둘 弈
바둑판	바둑판 楸 枰
바디집	바디집 軸
바라볼	바라볼 眺
바로볼	바로볼 瞠
바리때	바리때 鉢 釪
바위굴	바위굴 岫 峀
바윗집	바윗집 广
바자울	바자울 埒
바퀴살	바퀴살 輻
바퀴테	바퀴테 輞
바퀴통	바퀴통 輹
반드시	반드시 堅 要 必
반딧불	반딧불 蠲 燐 燐 螢
반복할	반복할 襲
반족할	반족할 溲
반포할	반포할 頒
발 벨	발 벨 剕
발기름	발기름 膋
발꿈치	발꿈치 踵
발끈할	발끈할 勃 艴
발바닥	발바닥 跖
발벗을	발벗을 跣
발설할	발설할 泄
발자국	발자국 迹
밝고흰	밝고흰 暠
밤나무	밤나무 栗
밤사냥	밤사냥 獠
밥 쉴	밥 쉴 饐
밥그릇	밥그릇 盧 盧 盂
방망이	방망이 杵 樀 柊
방자할	방자할 肆 恣
방칫돌	방칫돌 砧
방탕할	방탕할 淫 弛 誕 蕩 宕
방패끈	방패끈 芮
방해할	방해할 妨
방향의	방향의 於
방황할	방황할 彷 徨
밭 갈	밭 갈 羫 圃
밭 맬	밭 맬 佃
밭갈피	밭갈피 畛
밭두둑	밭두둑 壟 畔 疇 畦
밭둑길	밭둑길 陌 阡
밭지경	밭지경 町
배다리	배다리 桁
배반할	배반할 叛 側
배부를	배부를 飫 饒 脹 飽
배저을	배저을 搒
배질할	배질할 航
배회할	배회할 徘 徉 徊
백 근	백 근 秤
백이랑	백이랑 頃
뱀장어	뱀장어 鰻
뱃머리	뱃머리 艫
번개빛	번개빛 睒
번뇌할	번뇌할 惱 懊
번데기	번데기 蛹
번민할	번민할 悶
번쇄할	번쇄할 糠
번역할	번역할 譯
번잡할	번잡할 宂 叢
번쩍할	번쩍할 閃
벌려설	벌려설 班
벗나무	벗나무 樺
벗어날	벗어날 脫
벗어진	벗어진 禿
벙어리	벙어리 啞 缿
벼 벨	벼 벨 穫
벼슬할	벼슬할 仕
벼이삭	벼이삭 穗
별배기	별배기 馰
별안간	별안간 驟
별이름	별이름 建 昴 始 搖 頊 氐 亢
별자리	별자리 躔
병고칠	병고칠 療
병아리	병아리 雛
병장기	병장기 戎 仗
병증세	병증세 症
볕 쬘	볕 쬘 曝
볕기운	볕기운 暣 晛
보따리	보따리 包
보랏빛	보랏빛 紺
보마기	보마기 洑
보배옥	보배옥 璵
보살필	보살필 守
보습날	보습날 錬
보증할	보증할 證
보호할	보호할 護
복돋을	복돋을 耔
복사뼈	복사뼈 踝
복종할	복종할 悅 柔
본받을	본받을 倣 視 則 效 傚
본보기	본보기 樣 型
볼기채	볼기채 箠 鞭
볼기칠	볼기칠 笞
볼록할	볼록할 凸
봄제사	봄제사 祠
봇도랑	봇도랑 洫 澮
봉양할	봉양할 養
봉우리	봉우리 嶁 峯 岑 巚
봉화대	봉화대 堠
봉황새	봉황새 凰
부끄럼	부끄럼 恥
부닥칠	부닥칠 捂
부들속	부들속 蒻
부들풀	부들풀 蒲
부딪칠	부딪칠 突 撲 着
부르틀	부르틀 疱
부릅뜰	부릅뜰 瞋
부서질	부서질 麋
부스럼	부스럼 瘻 癤 腫 瘡
부엉이	부엉이 鴟
부추길	부추길 唆
부추꽃	부추꽃 菁
부추킬	부추킬 煽
부탁할	부탁할 付 寓 屬 囑 託
북 칠	북 칠 搥
북나무	북나무 栲
북돋울	북돋울 培 壅
북돋을	북돋을 培
북동쪽	북동쪽 丑
북망산	북망산 邙
북상투	북상투 髽 魋
북소리	북소리 塡 彭
분개할	분개할 慨
분명할	분명할 著
분별할	분별할 揀 辨 爭 正
분부할	분부할 咐
분분할	분분할 搔
분석할	분석할 晳
분홍빛	분홍빛 縉 纁
불 땔	불 땔 炬
불기운	불기운 熢 熏
불날릴	불날릴 票
불덮개	불덮개 篝
불러올	불러올 致
불사를	불사를 焚 爇 燒 然 燃 煆 焮
불성할	불성할 熾
불쌍한	불쌍한 愍
불쌍할	불쌍할 惻
불안할	불안할 傝
불터질	불터질 爆
불한당	불한당 寇
붉은옥	붉은옥 瓊 瑾
붉은흙	붉은흙 赭
붙어살	붙어살 僑 寓
붙여살	붙여살 寄
붙잡을	붙잡을 拿 拏 挐 拏 攫
비교할	비교할 撿 較 讎 試
비녀장	비녀장 錧
비둘기	비둘기 鳩 鸏
비로소	비로소 始 哉 肇 創 祝
비롯할	비롯할 甲 首 俶 載 纔 肇 創 刱 殆
비린내	비린내 腥 鰺
비밀할	비밀할 秘
비방할	비방할 詆
비색할	비색할 閊
비슷할	비슷할 髣 彿 髴 依
비웃을	비웃을 哂 嗤 咍
비유할	비유할 譬 諭 喩 依
비젖을	비젖을 渥
비취새	비취새 翡
비취옥	비취옥 琰
비평할	비평할 批
빈 땅	빈 땅 堧
빈지문	빈지문 蔀
빗치개	빗치개 篦
빙자할	빙자할 寓 鰌
빨래할	빨래할 漱 濯 澣
빼앗을	빼앗을 虔 劫 軋 攘 簒 取 奪
빼어날	빼어날 桀 儻 秀 穎 挺 倜
빽빽할	빽빽할 密 稠 稠 綢 緻
뺑대쑥	뺑대쑥 蓍
뺑때쑥	뺑때쑥 蓍
뻐꾸기	뻐꾸기 鴶
뻐꾹새	뻐꾹새 鵑
뽕나무	뽕나무 桑
뾰루지	뾰루지 痤
뾰족할	뾰족할 凸 尖
뿔난소	뿔난소 犀
뿜어낼	뿜어낼 噴
사과꽃	사과꽃 莉
사나울	사나울 彊 獷 猛 猜 愎 暴 暴 虐 悍
사나을	사나을 桀
사나이	사나이 郎 郞
사냥할	사냥할 獵 田 佃 畋
사다리	사다리 棚 援 棧 梯
사라질	사라질 消 銷
사랑방	사랑방 塾
사랑할	사랑할 懊 玉 忨 偎 幼 恩 應 慈 寵 親 嬖 倖 惠
사례할	사례할 訣 謝
사립문	사립문 扉 扇
사마귀	사마귀 蟷 蜋 痣
사모할	사모할 戀 慕 淑 孺
사무칠	사무칠 遂 通 透 浹
사발종	사발종 錞
사방풍	사방풍 颶
사실할	사실할 査
사양할	사양할 謙 遜 巽 讓
사잇길	사잇길 徯
사철쑥	사철쑥 茵 蔯
사치할	사치할 奢 侈 汰
사태날	사태날 阤
사통대	사통대 筒
사패땅	사패땅 埰
산가지	산가지 筮
산고개	산고개 嶺 嶺
산골물	산골물 澗 磵
산기슭	산기슭 麓
산뜻할	산뜻할 嬛
산모양	산모양 屹
산부추	산부추 韱
산비탈	산비탈 阪 坂
산앵두	산앵두 栯
산유자	산유자 楸
산이름	산이름 崑 崆 岣 峱 岱 峒 嵋 岷 崇 嵩 崧 嵔 崙 嶷 碭 圃 峴 峽
산초목	산초목 岵
산허리	산허리 岬
산흰쑥	산흰쑥 蘩
살무사	살무사 蝮 虺
살평상	살평상 簀
삼나무	삼나무 杉
삼백초	삼백초 蕺
삼태기	삼태기 畚
삼합노	삼합노 糾
삽살개	삽살개 尨
삿자리	삿자리 簟
상고할	상고할 考
상수리	상수리 芧
상앗대	상앗대 篙 櫂
상제될	상제될 憂
새그물	새그물 羅
새김칼	새김칼 剞
새끼양	새끼양 羔
새로울	새로울 鼎
새발쑥	새발쑥 莪
새소리	새소리 咬 鳴 嘎
새이름	새이름 雇 鷱 痺 翳
새파랄	새파랄 黛
새풀싹	새풀싹 芿
샘솟을	샘솟을 潗
생각할	생각할 攷 伋 慮 思 想 案 願 惟 悠 恁 靖 慒
생선뼈	생선뼈 鯁
서까래	서까래 桷 椽 榱
서늘할	서늘할 凉 樑 涼 澟 滄 凊 湫
서두를	서두를 緣
서러울	서러울 慟
서북쪽	서북쪽 乾
서운할	서운할 欿 觖
서있을	서있을 竪
석간수	석간수 磵
석달복	석달복 緦
석비레	석비레 矽
석죽화	석죽화 蘧
섞인돌	섞인돌 礖
선명할	선명할 熠
설만할	설만할 暬
설치할	설치할 洒
섬섬할	섬섬할 摻
섭섭할	섭섭할 憾 惆
성 밖	성 밖 郊
성가퀴	성가퀴 陴 堞
성성이	성성이 猩
성실할	성실할 矼 精
성하게	성하게 祁
세모창	세모창 厹
세밀할	세밀할 精
세수할	세수할 頮
센 활	센 활 彊
셈놓을	셈놓을 算
소개할	소개할 紹 佋
소고삐	소고삐 鞅
소금밭	소금밭 滷
소나기	소나기 瀑
소나무	소나무 松
소동할	소동할 騷
소리개	소리개 鷳
소리살	소리살 矢
소말뚝	소말뚝 枕
소명할	소명할 昭
소쿠리	소쿠리 簞
소탕할	소탕할 蕩
소태성	소태성 馰
소회향	소회향 蒔
속 빌	속 빌 腔
속눈섭	속눈섭 睫
속눈썹	속눈썹 睫
속바칠	속바칠 贖
속바퀴	속바퀴 軸
속삭일	속삭일 呤
속적삼	속적삼 袛
손가락	손가락 指
손바닥	손바닥 掌 扺
손뼉칠	손뼉칠 抃 擺
손수건	손수건 帨
손수레	손수레 輦
손아귀	손아귀 握
송골매	송골매 鶻
송구할	송구할 悚
송나라	송나라 宋
송사할	송사할 訴 訟 鬩
송아지	송아지 犢
쇠고랑	쇠고랑 梏
쇠뇌틀	쇠뇌틀 錡
쇠마치	쇠마치 鎚
쇠뭉치	쇠뭉치 椎
쇠불릴	쇠불릴 鍛 鍊 煉 冶 鍊 鑄
쇠사슬	쇠사슬 鏈 鎖
쇠시랑	쇠시랑 耙
쇳덩이	쇳덩이 鑛 鋌
쇳소리	쇳소리 錚 鈜
쇳조각	쇳조각 鏶
수결둘	수결둘 檢
수고할	수고할 勞 肄
수나라	수나라 隋
수놓을	수놓을 繡 絢
수레끌	수레끌 輓
수알치	수알치 鴟
수자리	수자리 戍
수죄할	수죄할 數
수준기	수준기 準
수척할	수척할 憔 嫶
수크령	수크령 莨
숙상말	숙상말 驌
숙상새	숙상새 鷫
순나무	순나무 栒
순나물	순나물 蓴
순라군	순라군 遉
순마룰	순마룰 蓴
순박할	순박할 樸 淳
순수할	순수할 粹 純 醇
순임금	순임금 舜
순전할	순전할 純
순종할	순종할 塡
순행할	순행할 邏 狩 巡
숟가락	숟가락 柶 匙 鍉
술 괼	술 괼 醱
술 깰	술 깰 醒 酲
술그릇	술그릇 樽 榼
술단지	술단지 樽
술추렴	술추렴 醵
술취할	술취할 醉
숨 쉴	숨 쉴 甦
숨겨질	숨겨질 薆
숨구멍	숨구멍 囟
숫사슴	숫사슴 麌
스러질	스러질 爚 歇
스며들	스며들 漓 沁
스스로	스스로 聿 自
슬이름	슬이름 瑰
슬퍼할	슬퍼할 悼 悢 憯 愴 悵 悽 怊 唏 悕
습격할	습격할 侵
승냥이	승냥이 豺
승인할	승인할 准
승전악	승전악 豈 凱
시금치	시금치 菠
시기할	시기할 猜 害 嫮
시냇물	시냇물 磎
시루봉	시루봉 巚
시마복	시마복 緦
시비할	시비할 訟 訔
시어미	시어미 姑
시원할	시원할 爽 快
시작할	시작할 始 俶
시중꾼	시중꾼 僕
시중들	시중들 徬
시집갈	시집갈 嫁 適
시험할	시험할 課 試 揣 驗
신기슭	신기슭 麓
신나무	신나무 楓
신바닥	신바닥 苴
신칙할	신칙할 勅 敕
신통할	신통할 詫
실 띠	실 띠 紃
실감개	실감개 楥
실개천	실개천 滎
실과씨	실과씨 瓣
실마디	실마디 統
실마리	실마리 系 緖
실심할	실심할 惆
실의할	실의할 侘
실패할	실패할 敝
싫어할	싫어할 避 嫌
심란할	심란할 憒
심오할	심오할 遠
싱거울	싱거울 澹
싸라기	싸라기 糜
싸락눈	싸락눈 霰 霰
싸움배	싸움배 艨
쌀쌀할	쌀쌀할 婷
쌍둥이	쌍둥이 孿 孖
쌍상투	쌍상투 丱
쓰러질	쓰러질 僵 蹶 靡
쓴나물	쓴나물 菫
쓸쓸할	쓸쓸할 寥 寞 蕭 寂 凄 淒
씨름할	씨름할 抵
씩씩할	씩씩할 業 壯 莊 血
아가씨	아가씨 娘 姐
아가위	아가위 棠
아궁이	아궁이 窹
아담할	아담할 雅
아당할	아당할 倖
아득할	아득할 漠 邈 茫 緬 渺 沕 杳 瀇 攸 玄
아롱범	아롱범 豹
아롱질	아롱질 斑 斐
아버지	아버지 外
아우를	아우를 兼 竝 倂
아이밸	아이밸 娠 姙 妊 孕
아재비	아재비 叔
아찔할	아찔할 眩
아첨할	아첨할 媚 諛 諂
아침밥	아침밥 饔
아침해	아침해 暾
악착할	악착할 齷 齪
안존할	안존할 窕
안치할	안치할 置
알 깔	알 깔 孵
알갱이	알갱이 顆
알맞을	알맞을 折
알소할	알소할 詆 詖
암고래	암고래 鯢 鰕
암사슴	암사슴 麀
압수할	압수할 籍
앙감질	앙감질 踔
앙징할	앙징할 呫
앞지를	앞지를 軼
애꾸눈	애꾸눈 眄 眇 瞎
애도할	애도할 悼
애무할	애무할 憮
애받을	애받을 寵
애통할	애통할 慟
액색할	액색할 覈
앵무새	앵무새 鵡 鸚
약속할	약속할 束
약이름	약이름 硼 萸 箭 蓽 香
양념할	양념할 韲
양잠기	양잠기 籧
어금니	어금니 牙
어긋날	어긋날 乖 訛 差 儳
어두울	어두울 眛 冥 溟 暝 曚 懞 杳 瞢 霧 暗 闇 黯 晻 愚 幽 昏
어떠할	어떠할 如
어려울	어려울 艱 難
어린벼	어린벼 穉
어머니	어머니 恃 媓
어여쁠	어여쁠 娟 姚 夭
어조사	어조사 哩 耶 焉 翳 矣 哉 兮 乎
어진이	어진이 獻
어혈질	어혈질 瘀
억울할	억울할 抑
억제할	억제할 制
언약할	언약할 偄 嫩 要
얼레빗	얼레빗 梳
얼룩말	얼룩말 駁
얼룩소	얼룩소 犖 犁
얽어맬	얽어맬 搆 縻
엄숙할	엄숙할 肅 湜
엄습할	엄습할 襲
업어질	업어질 撲
없어질	없어질 熄 湮 蕩
엇살창	엇살창 牖
엎드릴	엎드릴 伏 仆 弊
여광대	여광대 倡
여덟치	여덟치 咫
여동생	여동생 娣
여물광	여물광 廥
여스승	여스승 姆
여자종	여자종 婢
여자중	여자중 尼
역마을	역마을 站
역말집	역말집 驛
연구할	연구할 致
연나무	연나무 櫞
연등절	연등절 燃
연락할	연락할 絡
연리할	연리할 怜
연마할	연마할 硏
연보라	연보라 紺
연뿌리	연뿌리 藕
연속할	연속할 携
연약할	연약할 嫩
연주창	연주창 瘰 癧
연탐할	연탐할 俔
열결할	열결할 訣
열사람	열사람 什
열어줄	열어줄 迪
열중할	열중할 凝
염려할	염려할 愁 虞
염습할	염습할 襲
염탐할	염탐할 遉 諜 探 詗
영검할	영검할 神
영락할	영락할 儡
영리할	영리할 伶
영리할	영리할 怜 悧 儇 翾
영특할	영특할 儁
옛 터	옛 터 墟
옛성터	옛성터 墟
오나라	오나라 吳
오똑할	오똑할 兀
오랑캐	오랑캐 羌 蠻 貃 弋 胡
오래될	오래될 去
오로지	오로지 專 顓 擅 必
오른쪽	오른쪽 右
오만할	오만할 敖 奓
오목할	오목할 凹
오소리	오소리 狢
오십명	오십명 偏
오줌통	오줌통 胱
오지병	오지병 鬲
오히려	오히려 尙 猶
옥 빛	옥 빛 璟
옥가루	옥가루 瑣
옥경쇠	옥경쇠 球 璆
옥고리	옥고리 玔 環
옥광채	옥광채 瑛
옥그릇	옥그릇 珣 瓚
옥소리	옥소리 琤 玎
옥이름	옥이름 珙 琪 瑭 玲 瑋 瑱
옥피리	옥피리 琯 珖
온량차	온량차 轀
온전할	온전할 純 全 囫
온화할	온화할 旼 春 沖 冲
올배미	올배미 梟
올빼미	올빼미 鶹 鴟 梟
올챙이	올챙이 蝌 蚪
옳게할	옳게할 修
옷 빨	옷 빨 浣
옷고름	옷고름 衿
옷마를	옷마를 裁
옷상자	옷상자 匧
옷소매	옷소매 袂
옹 솥	옹 솥 驘
옹기장	옹기장 旊
옹색할	옹색할 乏
옻나무	옻나무 漆
옻칠할	옻칠할 柒 髹
와전될	와전될 譌
왁자할	왁자할 籍
완고할	완고할 頑
완악할	완악할 頑
완전할	완전할 完
왕개미	왕개미 蚍 蟻
왕성할	왕성할 旺
왕이름	왕이름 桀
왜가리	왜가리 鴃
외로울	외로울 煢 孤 孑
외삼촌	외삼촌 舅
외숙모	외숙모 妗
외조모	외조모 嫽
외줄기	외줄기 梃
요구할	요구할 乞
요긴할	요긴할 緊
요량할	요량할 揣
요사할	요사할 妖
요임금	요임금 堯
욕심낼	욕심낼 欲 慾 貪
용나무	용나무 榕
용납할	용납할 閱 儲 包 畜
용렬할	용렬할 劣 体 傝
용마루	용마루 棟
용맹할	용맹할 敢 勇
용서할	용서할 赦 恕 饒 容 又
우거질	우거질 莽 茂 蕃 蓊 蓁
우뚝할	우뚝할 言 兀 魏 矗 最 特 伉
우러를	우러를 仰 顒
우렁찰	우렁찰 蜵
우아할	우아할 嫺
우아할	우아할 嫻
우줌눌	우줌눌 溺
운전할	운전할 運
울타리	울타리 籬 藩 園 砦 笆
움겨질	움겨질 扼
움직일	움직일 撼 擧 動 運 云 摘 躁 盪 波 漂
움켜쥘	움켜쥘 扼 搤
움켜질	움켜질 握
움펑눈	움펑눈 窅
웅거할	웅거할 據
웅덩이	웅덩이 汚 窊 瀦 潢
웅장할	웅장할 雄
워라말	워라말 驎
원나라	원나라 阮
원두막	원두막 廬 廬
원만할	원만할 圓
원망할	원망할 懟 誦 怏 恚 懊 怨 咨
원숭이	원숭이 獼 申 猿 狨 狙 猢 猴
원추리	원추리 萱
원추새	원추새 鵷
원통할	원통할 枉 寃 冤
월나라	월나라 越
위나라	위나라 魏
위로할	위로할 慰
위문할	위문할 閔 弔
위유풀	위유풀 葳
위태할	위태할 圾 陲 業 危 殆
위협할	위협할 劫 脅 恊
유리돌	유리돌 琉
유리옥	유리옥 玻
유순할	유순할 嫛 宜
윤택할	윤택할 睟 演 澤
율이름	율이름 洗
융성할	융성할 殷
융통할	융통할 融
으슥할	으슥할 歇
은근할	은근할 懃 慇
은나라	은나라 殷
읊조릴	읊조릴 謳 呻
음란할	음란할 猥 淫
음산할	음산할 曀
음역자	음역자 乧 乷
음위증	음위증 痿
의논할	의논할 惲 議 擬 訂 叅
의심낼	의심낼 惢 猜 貳
의심할	의심할 訝 疑 二 忒 嫌
의젓할	의젓할 喧
의지할	의지할 據 据 憑 循 恃 隱 依 倚 仗 溘
의탁할	의탁할 附 投
이 갈	이 갈 齔
이간할	이간할 諜
이따금	이따금 往
이로울	이로울 利
이름날	이름날 譽
이무기	이무기 蟒 蜃
이별할	이별할 決 訣 貳
이야기	이야기 噺 話
이어질	이어질 邐 綿
이전의	이전의 仍
익숙할	익숙할 慣 翫
인도할	인도할 導 儐 鉥 誘 牖 前
인색할	인색할 吝 嗇 吝
인쇄할	인쇄할 刷 版
인중방	인중방 楣
일걸을	일걸을 擧
일깨울	일깨울 欬
일마칠	일마칠 竣
일어날	일어날 起 發 浡 催 興
일컬을	일컬을 稱
임금께	임금께 寵
임신할	임신할 娠
입가실	입가실 嗽
잇닿을	잇닿을 連 驛 接
자귀밥	자귀밥 薥
자랑할	자랑할 誇 夸 侉 矜 訑 侘 詫 衒 詡 詑
자만할	자만할 武
자물쇄	자물쇄 鎖
자물쇠	자물쇠 鈐 鎖 鑰
자백할	자백할 首
자빠질	자빠질 偃 斃
자세할	자세할 縷 詳 仔 核
자욱할	자욱할 郁
자주빛	자주빛 紫
작은집	작은집 廑
잔나비	잔나비 猿
잔말할	잔말할 嗑
잔무늬	잔무늬 蔚
잔약할	잔약할 孱
잔질할	잔질할 挹 勺
잔치할	잔치할 宴 饗
잠꼬대	잠꼬대 啽
잠방이	잠방이 褌 襠
잠잠할	잠잠할 默
잡곡밥	잡곡밥 糅
잣나무	잣나무 栢 柏
장가들	장가들 取 娶
장기판	장기판 枰
장딴지	장딴지 腓
장마물	장마물 沈
장목기	장목기 旌
장미꽃	장미꽃 薔
장수할	장수할 壽
장자리	장자리 蛉
장중할	장중할 庄
장황할	장황할 娓
재계할	재계할 齋
재관관	재관관 平
재촉할	재촉할 促 催
쟁개비	쟁개비 銚
저녁밥	저녁밥 飧
저울눈	저울눈 銖 錘 錙
저울대	저울대 衡
저자문	저자문 闠
저지할	저지할 摧
전국술	전국술 醇
전나무	전나무 檜 樅
전념할	전념할 迷
전방석	전방석 氈
전위할	전위할 禪
전일할	전일할 專
절이름	절이름 岾
점령할	점령할 占
접근할	접근할 襯
접동새	접동새 鵑
젓가락	젓가락 箸
정강이	정강이 脛
정결할	정결할 潔 瀞
정교할	정교할 精
정나라	정나라 鄭
정녕할	정녕할 嚀
정다울	정다울 綣
정돈할	정돈할 整
정리할	정리할 修
정색할	정색할 愀
정수리	정수리 囟
정숙할	정숙할 婐 窕
정어리	정어리 鰯
정제할	정제할 盛
정탐할	정탐할 偵 俔
젖먹이	젖먹이 孺
젖먹일	젖먹일 乳
제거할	제거할 擺
제비쑥	제비쑥 蔚
조개풀	조개풀 菉 菉
조급할	조급할 卞 惼
조나라	조나라 趙
조롱박	조롱박 葫
조롱할	조롱할 嘲 詼
조릿대	조릿대 篠
조밀할	조밀할 稠
조상할	조상할 弔
조수할	조수할 狷
조심할	조심할 兢 夔 夤 屬
조아기	조아기 荇
조아릴	조아릴 頓
조약돌	조약돌 礫
조용할	조용할 惺 愔 靜
조자리	조자리 耳
조촐할	조촐할 蠲 潔 洗 涓 淨
조화할	조화할 諧 協
조회할	조회할 述
족제비	족제비 鼬
족집개	족집개 箝
존귀할	존귀할 尊
좀도둑	좀도둑 竊
좀먹을	좀먹을 蠡 蝕
종소리	종소리 鎤
종아리	종아리 脚
종유석	종유석 乳
종이돈	종이돈 楮
종지뼈	종지뼈 臏 膝
좋아할	좋아할 樂
좋은말	좋은말 驌
주관할	주관할 宰
주근깨	주근깨 癡
주둥이	주둥이 喙
주머니	주머니 囊 袋 褚
주먹쥘	주먹쥘 捲
주사위	주사위 骰
주선할	주선할 斡
주장할	주장할 帥 適
주저할	주저할 躊 跱
주적댈	주적댈 軒
주정할	주정할 酗
주차할	주차할 呰
주춧돌	주춧돌 榰 礎
죽은깨	죽은깨 疵
줄어들	줄어들 遬 縮
줄풍류	줄풍류 絃
중개인	중개인 娶
중매할	중매할 介
중풍증	중풍증 癱
중험할	중험할 驗
즐거울	즐거울 康 湛 樂 悅 娛 虞 愉 怡 悰 耽 僖
증경이	증경이 雎
증류수	증류수 溜
지게미	지게미 粕 糟
지극할	지극할 極 聖 諄 腆
지껄일	지껄일 嘈 喧
지나갈	지나갈 殊
지나칠	지나칠 涉 透
지도리	지도리 樞
지두리	지두리 樞
지랄병	지랄병 癲
지렁이	지렁이 蚯 蚓 蚕
지레목	지레목 陘
지렛대	지렛대 槓
지름길	지름길 徑 兌 蹊
지붕일	지붕일 葺
지아비	지아비 夫
지칭개	지칭개 莪
지탱할	지탱할 支
지팡이	지팡이 杖
직언할	직언할 諤
진나라	진나라 秦
진나팔	진나팔 壎
진동할	진동할 震 盪
진맥할	진맥할 切 診
진수렁	진수렁 溏
진실로	진실로 苟 允
진실할	진실할 恂
진압할	진압할 鎭
진열할	진열할 廞
진펀할	진펀할 沆
진휼할	진휼할 賙
질경이	질경이 芣 苡
질그릇	질그릇 甄 陶 瓦
질나팔	질나팔 壎 塤
질박할	질박할 朴
질주할	질주할 騖
질투할	질투할 嫉 妬
질펀할	질펀할 漫
짊어질	짊어질 佗
짐바리	짐바리 輸
짐수레	짐수레 輜
짐작할	짐작할 斟 忖
집세울	집세울 構
집오리	집오리 鶩 鴨
짓밟을	짓밟을 躪 躙
짓찧을	짓찧을 椎 捶
징계할	징계할 懲
짖밟을	짖밟을 躪
짝지울	짝지울 偶
쪽집게	쪽집게 鑷
쭉정이	쭉정이 秕 粃
찌푸릴	찌푸릴 欿 湫
찡그릴	찡그릴 嚬 顰 矉 蹙
찢어질	찢어질 拆 披
차 싹	차 싹 茗
차가운	차가운 泂
차가울	차가울 冷
차단할	차단할 迥
차라리	차라리 寗
차별할	차별할 擇
차조기	차조기 蘇 茣
찬란할	찬란할 燦
찬바람	찬바람 冽 凩
찬이슬	찬이슬 瀣
찰진흙	찰진흙 埴 埴
참나무	참나무 棌 椎
참람할	참람할 儗 僭
참소할	참소할 愬 咠 讒 譖
참여할	참여할 預
참작할	참작할 酌
참조개	참조개 蜊
참혹할	참혹할 慘
창고달	창고달 錞 鐓 鐏
창성할	창성할 昌
창자젓	창자젓 鮧
창피줄	창피줄 媿 謑
창피할	창피할 被
찾아볼	찾아볼 訪
채나라	채나라 蔡
채마밭	채마밭 圃
채색할	채색할 沈
책상자	책상자 笈
처량할	처량할 騷
처이모	처이모 姨
처자식	처자식 帑 帑
천거할	천거할 薦
천리마	천리마 驥 騏
천사람	천사람 仟
천징어	천징어 鱇 鮟
천천할	천천할 徐
철쭉꽃	철쭉꽃 躅
철총이	철총이 駽
첩육경	첩육경 膵
첩자식	첩자식 孼
청구할	청구할 匃
청렴할	청렴할 廉
청명할	청명할 曣
쳐다볼	쳐다볼 瞻
초.실	초.실 酸
초결명	초결명 茪
초나라	초나라 楚
초록빛	초록빛 綠 綠
초벌갈	초벌갈 塌
초췌할	초췌할 悴
초하루	초하루 朔
촉규화	촉규화 薥
촉박할	촉박할 促
촌백충	촌백충 蟯
촘촘할	촘촘할 芸
총명할	총명할 慧
총소리	총소리 彭
총이말	총이말 驄
추나라	추나라 鄒
추녀끝	추녀끝 軒
추락할	추락할 墜
추창할	추창할 蹌 趨 趣
축복할	축복할 壽
축축할	축축할 墊
축하할	축하할 賀
충돌할	충돌할 毄 衝
충동할	충동할 吹
취급할	취급할 扱
측량할	측량할 測
층층대	층층대 層
치료할	치료할 治
치벌레	치벌레 蚩
치부책	치부책 賬
치슬말	치슬말 膝
치우칠	치우칠 個 偏 陂
치자꽃	치자꽃 蔔
치켜들	치켜들 掀
친근할	친근할 狎
칠근할	칠근할 暱
침노할	침노할 冉 迭 侵
침비깨	침비깨 胆
침침할	침침할 朧
칭송할	칭송할 頌
칭찬할	칭찬할 揚 敭 譽 揄 讚
칼 갓	칼 갓 翮
칼 끝	칼 끝 鉾
칼날끝	칼날끝 鍔
칼자루	칼자루 杷
칼칼할	칼칼할 怦
캐물을	캐물을 査 劾
커피차	커피차 咖
코끼리	코끼리 象
콧마루	콧마루 頞
콩자반	콩자반 豉
큰 개	큰 개 犬
큰 곰	큰 곰 羆
큰 늪	큰 늪 藪
큰 닭	큰 닭 蜀
큰 띠	큰 띠 紳
큰 말	큰 말 騋
큰 물	큰 물 潡 沆
큰 배	큰 배 舸 奚
큰 비	큰 비 潦 沱
큰 산	큰 산 岳
큰 옥	큰 옥 珙
큰 종	큰 종 鐄
큰 집	큰 집 厦
큰 집	큰 집 廈
큰물결	큰물결 濤 瀾
큰바늘	큰바늘 鉥
큰방울	큰방울 鐸
큰사슴	큰사슴 麋
큰언덕	큰언덕 陵
클말할	클말할 哃
타넘을	타넘을 跨
타락죽	타락죽 酥
타협할	타협할 妥
탄생할	탄생할 誕
탄식할	탄식할 忼 愁 烏 嗚 猷 吟 猗 齎 嗟 歎 嘆 噓 噫 戲
탄핵할	탄핵할 彈 抨
태나라	태나라 邰
태나무	태나무 梨
태만할	태만할 惰
턱밑살	턱밑살 胡
턱수염	턱수염 鬚
털총이	털총이 騏
톡톡할	톡톡할 緻
통갈비	통갈비 骿
통나무	통나무 樸
통달할	통달할 達 顯
통변할	통변할 譯
투기할	투기할 妬 妒
퉁노구	퉁노구 鋗
트림할	트림할 噯
특별할	특별할 特 扁
튼튼할	튼튼할 獜
파려옥	파려옥 玻
파리할	파리할 羸 瘦 膄 尫 瘠 憔 悴
판단할	판단할 判
판장문	판장문 窬
팔꿈치	팔꿈치 肘
팔다리	팔다리 肢
팔대손	팔대손 雲
팔마디	팔마디 臑
팔짱길	팔짱길 拱
페이지	페이지 頁
편안할	편안할 康 愷 祇 恬 寧 寧 寗 宓 綏 禔 安 晏 億 宴 燕 厭 懕 豫 穩 逸 佚 適 定 靜 靖 妥 泰
편차할	편차할 篇
편협할	편협할 狷 惼
평고대	평고대 梠 桭
평두목	평두목 槪
평론할	평론할 詮 評
평안할	평안할 宖
평탄할	평탄할 平
평평할	평평할 夷 坦 平 坪
포대기	포대기 襁 褓
포장할	포장할 褒
포흠할	포흠할 逋
폭발할	폭발할 爆
폭포수	폭포수 瀑
표독할	표독할 剽
표시할	표시할 甄 旌 標
표주박	표주박 瓢 瓠
표준될	표준될 憲
푸서리	푸서리 菹
푸줏간	푸줏간 庖
풀 벨	풀 벨 乂
풀 벨	풀 벨 刈 蔪
풀가시	풀가시 莿
풀어낼	풀어낼 嬴
풀이름	풀이름 薛 葊
풀칠할	풀칠할 糊
품팔이	품팔이 賃
풍년들	풍년들 熟 昇 壤 穰
풍뎅이	풍뎅이 蜚
풍부한	풍부한 朦
풍부할	풍부할 朦 侈
풍유할	풍유할 誦
피곤할	피곤할 損 疲
피바를	피바를 釁
피붙이	피붙이 血
피폐할	피폐할 悴
핍박학	핍박학 逼
핍박할	핍박할 迫 拶 促 催 逼 偪
핏기운	핏기운 衞
핑계할	핑계할 諉 託
하관들	하관들 楹
하관할	하관할 窆
하례할	하례할 賀
하물며	하물며 矧 況
하여금	하여금 令 使 爲
하우씨	하우씨 禹
하품할	하품할 欠
한 길	한 길 版
한 배	한 배 胞
한가지	한가지 共 同
한가할	한가할 悠 閑 閒
한나라	한나라 韓
한마리	한마리 匹
한산할	한산할 冗
한숨쉴	한숨쉴 欸 喟 嘆
한아람	한아람 圍
한정할	한정할 限
한탄할	한탄할 惋 恨
한혐할	한혐할 憾
할머니	할머니 婆
할미새	할미새 鴒
함께할	함께할 偕
합사할	합사할 祔
항거할	항거할 抗
항복할	항복할 攝 降
항아리	항아리 垌 甕 瓮 缸 壺
해나무	해나무 楷
해돋을	해돋을 暹 晧 昕
해돋이	해돋이 暘
해무리	해무리 旺 珥
해산할	해산할 娩
해어질	해어질 消
해이할	해이할 弛
해치양	해치양 豸
핵실할	핵실할 劾 覈
햇무리	햇무리 珥
향기날	향기날 咇 蒿
향나무	향나무 檀 栴 柙
향내날	향내날 馝
향냐날	향냐날 郁
향부자	향부자 莎
향상할	향상할 丞
허깨비	허깨비 幻
허락할	허락할 諾 諾 然 唯 允 許
허리뼈	허리뼈 髖
허망할	허망할 妄
허비할	허비할 費
헌걸찰	헌걸찰 偈 赳 頎
헐떡일	헐떡일 喘
헐뜯을	헐뜯을 謗 誹 訕 姍 訾
헐어질	헐어질 敗
험난할	험난할 險
헛말할	헛말할 食
헛소리	헛소리 譫
헤아릴	헤아릴 斛 括 揆 量 料 率 商 率 數 億 茹 營 擬 裁 程 寸 忖 測 稱 度 評 絜
헤어질	헤어질 另
헤엄칠	헤엄칠 泳 游
혁혁할	혁혁할 傛
현혹할	현혹할 眩
협력할	협력할 勠
형벌틀	형벌틀 椄
형언니	형언니 哥
형통할	형통할 通 亨
호궤할	호궤할 犒
호박개	호박개 獒
호위할	호위할 衛 護 扈
혹독할	혹독할 虐 酷
혼인할	혼인할 姻 婚
혼탁할	혼탁할 沌
혼후할	혼후할 惲
홀바탕	홀바탕 邸
홀아비	홀아비 鰥
홈 통	홈 통 椧
홑이불	홑이불 裯
홑휘장	홑휘장 幃
화답할	화답할 歎
화락할	화락할 陶
화목할	화목할 睦 成
화목할	화목할 穆
화살대	화살대 竿
화살촉	화살촉 鏑 鋌 鏃
화창할	화창할 暢
화친할	화친할 平
화톳불	화톳불 燎
화평할	화평할 誾 愔
화합할	화합할 叶
확실할	확실할 确 確 碻
확자할	확자할 藉
활고자	활고자 弭
활고지	활고지 簫
활깍지	활깍지 闓
활당길	활당길 彎
활발할	활발할 潑
활시위	활시위 弦
활줌통	활줌통 敝
황겁할	황겁할 怔
황급할	황급할 汒
황무지	황무지 蕪
황홀할	황홀할 惚 恍
홰나무	홰나무 槐
회양목	회양목 枰
회초리	회초리 楚
회향풀	회향풀 茴
효도할	효도할 孝
후미질	후미질 僻
훨훨날	훨훨날 翬
휘두를	휘두를 揮
휘저을	휘저을 搔
휘추리	휘추리 肄 蓽
휘파람	휘파람 嘯
휙 불	휙 불 嘌
흉년들	흉년들 儉 歉 饑
흉악할	흉악할 兇
흐느낄	흐느낄 欷
흐릿할	흐릿할 朧 瞹
흔들릴	흔들릴 掉 騷
흘겨볼	흘겨볼 睥 盻
흘러갈	흘러갈 泝
흘레할	흘레할 風
흙덩이	흙덩이 塊 墣
흙탕칠	흙탕칠 淆
흠향할	흠향할 享 饗 歆
흡사할	흡사할 擬
흡족할	흡족할 飽 恰
흥정할	흥정할 市
흩뿌릴	흩뿌릴 濺
흩어질	흩어질 潰 散 俵 披 歇 渙
희롱할	희롱할 弄 弄 揶 敖 玩 揄 嘲 謔 戲
희미할	희미할 曖 仄
흰 흙	흰 흙 堊
흰비단	흰비단 縞
힐문할	힐문할 詰
힘 쓸	힘 쓸 佸
힘들일	힘들일 辦
힘많을	힘많을 劤
가게	가게 鄽 店
가끔	가끔 時
가늘	가늘 微 纖 孅 細 瑣 瘦
가둘	가둘 鎖 囚 圄
가람	가람 江
가래	가래 痰 鍤 銛 錢 鍬 鍫
가령	가령 就
가로	가로 橫
가뢰	가뢰 螌
가루	가루 粉 屑
가를	가를 刳 疈 析 揃 支
가릴	가릴 揀 柬 掄 冒 選 掩 奄 蔭 遮 推 琢 擇 閉 蔽 亢
가마	가마 轎 釜 轝 鑊
가멸	가멸 富
가문	가문 閥
가물	가물 旱
가방	가방 鞄
가사	가사 袈 裟
가선	가선 紕
가슴	가슴 臆 膺 胸
가시	가시 荊
가위	가위 剪
가을	가을 秋
가장	가장 尤 最
가죽	가죽 皮 革
가지	가지 柯 茄 件 條 枝 品
가질	가질 据 拷 所 送 勝 擁 齎 持 携
가짜	가짜 贋
가축	가축 畜
각각	각각 各
간방	간방 艮
간장	간장 醬
간질	간질 癎
간할	간할 諫 諍 証 誧
갇힐	갇힐 纍 囚
갈골	갈골 藎
갈기	갈기 鬐 鬣
갈대	갈대 葭 蒹 蘆 蘆 葦 荻 芦
갈비	갈비 胠 肋 脇
갈옷	갈옷 褐
갈피	갈피 疆
감귤	감귤 柑
감길	감길 繚
감실	감실 龕
감쌀	감쌀 容 護
감옥	감옥 監 囹 獄
감을	감을 紮
감자	감자 柑 薯 藷
감출	감출 去 區 韜 隩 韞 窩 藏 貯 蓄 呑
감할	감할 減 殺 貶
감히	감히 敢
갑옷	갑옷 甲 鉀 鎧
갑절	갑절 倍
갑주	갑주 革
갓끈	갓끈 紘 纓 珩
갓옷	갓옷 裘
강별	강별 罡
강철	강철 鋼 鏤 鑌
강초	강초 絳
강할	강할 强 姜 右
갖출	갖출 具 備 虞 全 詮 峙 跱 飭 辦 該
같을	같을 皆 同 仝 似 若 如 與 仵 猶 二 醜 齒 稱 合
갚을	갚을 報 償 酬 讎 售
개수	개수 箇
개천	개천 渠 溝 瀆 瀅
개펄	개펄 鹵 潟
객사	객사 館
갯가	갯가 浦
거닐	거닐 彷 逍
거덜	거덜 騶
거둘	거둘 捲 糺 斂 穡 攝 稅 收 拾 掩 臧 撤 抽 揫 縮 取
거듭	거듭 沓 成 習 申 原 再 臶 疊 層 弼
거루	거루 杭
거를	거를 瀝 漉 湑
거리	거리 街 衝 巷
거미	거미 蛛 鼄 蜘
거북	거북 龜 龜 龜 鼊 蔡
거울	거울 鑑 鑒 鏡
거위	거위 鵝 蛔
거의	거의 垂 汔
거지	거지 乞
거짓	거짓 假 陽 佯 譌 僥 僞 僭 虛
거칠	거칠 笨 穢 蕘 粗 麤 荒
거품	거품 沫
건널	건널 渡 濟 杭 蹊
건량	건량 餱
건질	건질 拯
건치	건치 腒
걷을	걷을 褰 撤 聚
걸레	걸레 帉
걸릴	걸릴 羂 係 攣
걸상	걸상 凳 桯
걸을	걸을 步
걸음	걸음 步
걸찰	걸찰 澆
검은	검은 點 点
검을	검을 黔 黮 黎 玈 黴 鴉 烏 蟻 弋 緇 淄 玄 黑
겁낼	겁낼 怯 恇 畏 慴 恊
게울	게울 哇 出
게타	게타 偈
겨레	겨레 族 戚
겨룰	겨룰 距 競 抗 伉
겨를	겨를 暇 濾 閒
겨리	겨리 耦
겨우	겨우 僅 纔
겨울	겨울 冬
겨자	겨자 芥
격문	격문 檄
격서	격서 檄
격식	격식 格
겪을	겪을 閱
견딜	견딜 堪 耐
견줄	견줄 較 比 視
결낼	결낼 憤
겸손	겸손 嗛
겸종	겸종 傔
겸할	겸할 兼 攝 該
겹옷	겹옷 複 褶 褺
경계	경계 域 垠
경기	경기 畿 圻 甸
경단	경단 餃
경사	경사 慶
경서	경서 經
경쇠	경쇠 磬
경옥	경옥 璥
경위	경위 緯
경치	경치 風
경풍	경풍 癎
곁굴	곁굴 嵌
곁마	곁마 駙 騑 驂
계단	계단 垓
계보	계보 譜
계제	계제 禊
계집	계집 女 姬
고개	고개 嶝 峠 岾 峴
고기	고기 肉
고깔	고깔 弁
고니	고니 鵠 鵠
고동	고동 樞
고래	고래 鯨
고를	고를 均 勻 水 旬 亭 調 平 諧
고름	고름 膿
고리	고리 環 鐶
고물	고물 舳
고비	고비 薇
고삐	고삐 韁 薇 縻 轡 紲
고생	고생 辛
고울	고울 麗 鮮 嬋 新 姸 艶 妧 旺 睍
고을	고을 郡 洞 歚 姸 邑 州 漼 聚 洞 縣 県
고자	고자 閹
고질	고질 痼
고치	고치 繭
고칠	고칠 改 更 刷 悛 評 革
고패	고패 轤
고할	고할 告 誥 愬 謂 諭 詔
고향	고향 梓 鄕
고환	고환 睾
곡기	곡기 薌
곡식	곡식 穀 糧 糧
곡척	곡척 矩 榘
곤장	곤장 棍 荊
곤할	곤할 困 弊 獘
곧을	곧을 梗 俓 是 矢 庭 貞 廷 直 矗 忠 兌
골목	골목 巷
골방	골방 穾
골집	골집 宕
골풀	골풀 莞 菅 藺 藺
곱할	곱할 乘
곳집	곳집 庫 廩 府 倉
공로	공로 施
공이	공이 杵
공적	공적 勣 勛
공해	공해 院 廨
공후	공후 箜 篌
공훈	공훈 閥
과거	과거 科
과녁	과녁 鵠 臬 的 正 侯 帿
과녘	과녘 埻
과부	과부 嫠 孀 召
과실	과실 果
과연	과연 有
과일	과일 菓
과자	과자 菓
과정	과정 科 程
곽란	곽란 癨
관디	관디 袍
관리	관리 吏
관원	관원 員
관청	관청 署 廳 廨
광대	광대 伶 俳 儒
광중	광중 窀 窆
괴수	괴수 魁 酋
괴일	괴일 倖
괸물	괸물 涔
교룡	교룡 蛟
교륭	교륭 螭
교의	교의 椅
구기	구기 杓 勺
구길	구길 縐
구들	구들 炕
구렁	구렁 洞
구를	구를 轉 軫
구름	구름 雲
구리	구리 銅
구멍	구멍 孔 窟 竅 竇 隧 穵 屇 兌 賢
구슬	구슬 瓘 球 璣 璇 琁 玉 珠
구실	구실 朌 賦 稅 租
구울	구울 灸 燔 煬 烊 炕
구유	구유 槽
구을	구을 灼
구장	구장 蒟
구절	구절 讀
구할	구할 迀 求 覓 亘 殉 要 邀 徼 詗 頀
국경	국경 版
국할	국할 賽
국화	국화 菊
군대	군대 隊
군량	군량 餉
군복	군복 韋
군사	군사 軍 旅 兵 卒
군인	군인 武
굳셀	굳셀 剛 疆 彊 祛 乾 健 堅 勁 勍 倞 逞 鏻 武 暋 偲 嚴 毅 行 偕 桓
굳을	굳을 剛 堅 硬 固 貞 侄 確 碻
굴궐	굴궐 宮
굴대	굴대 釭 軸
굴똑	굴똑 堗
굴뚝	굴뚝 堀
굴레	굴레 羈 勒 勒
굴릴	굴릴 轉
굵을	굵을 太
굶길	굶길 餒
굶을	굶을 餓
굽을	굽을 倨 曲 枸 屈 詘 卷 彎 宛 枉 猥 迂 紆 焌
굽힐	굽힐 辱 寃 乙
굿할	굿할 賽
궁궐	궁궐 宮
궁녀	궁녀 嬙
궁술	궁술 射
권세	권세 權 勢
권할	권할 迀 勸 慂 侑 慫
궤양	궤양 疳
궤짝	궤짝 匣 櫃
귀글	귀글 詩
귀녀	귀녀 嬪
귀신	귀신 鬼 祕 神 幽
귀인	귀인 豪
귀할	귀할 貴
규방	규방 閤
규소	규소 硅
그네	그네 韆 鞦
그늘	그늘 陰 蔭
그럴	그럴 然 兪
그루	그루 株
그릇	그릇 器 皿 碗
그릴	그릴 描 埽 猷
그림	그림 圖 畵 畫 繪
그물	그물 車 罟 罔 網 罠 罘 罦 罨
그믐	그믐 晦
그슬	그슬 炰
그을	그을 劃
그을	그을 畫
그칠	그칠 曷 彌 弭 息 碍 禦 奄 已 底 沮 踆 止 戢 輟 畜
근본	근본 綱 本 原 氐 統
근심	근심 罹 愁 濕 恙 憂 患
근원	근원 源
글귀	글귀 偈 句 詩
글방	글방 黌
글월	글월 文
글자	글자 字
긁는	긁는 刮
긁을	긁을 抉 搔 刷 爬 剽
금계	금계 鷩 鵔
금치	금치 赤
금풀	금풀 芩
금할	금할 禁 敔
급할	급할 渴 愷 遽 激 絿 窘 急 騷 切 褊 暴 曓 慓 翾 遑
긋날	긋날 齬
기계	기계 械
기내	기내 寰
기댈	기댈 據 靠 依 倚
기둥	기둥 楔 楹 柱 亢
기를	기를 鞠 牧 息 養 乳 育 毓 誕 豢 畜
기름	기름 膏 肪 油 脂
기린	기린 麒 麟 麟
기릴	기릴 頌 譽 讚 敕
기미	기미 幾
기쁠	기쁠 豫 怡 兌 欣 喜 僖 憘
기생	기생 妓
기슭	기슭 隅
기약	기약 必
기와	기와 瓦 磚 甎
기운	기운 氣 炁 氛 絪
기울	기울 傾 衲 補 線 繕 葺 仄 厠
기장	기장 粱 黍 稷 薌
기지	기지 坧
기침	기침 謦 咳
기회	기회 勢
기후	기후 候
길쌈	길쌈 紡 績 緝
길을	길을 汲
길이	길이 咫
길할	길할 祺 吉
김맬	김맬 耨 耘
김치	김치 醃 菹
깃대	깃대 杠 幟
깃발	깃발 旒 勿 游 斿
깃술	깃술 旒 斿
깃촉	깃촉 翮
깆출	깆출 備
깊을	깊을 潭 深 淵 奧 澳 窪 窈 幽 浚 濬 漼 沖 冲 測 洞 泓
까닭	까닭 以
까불	까불 播
까치	까치 鵲
깍을	깍을 刮 劘 削 刪 剗
깍일	깍일 剋
깍지	깍지 韝
깎을	깎을 鎊 削 刪 剷 刓 斲 剟 奪
깔개	깔개 藉
깔볼	깔볼 誣 媟 驁
깜짝	깜짝 恝
깨물	깨물 嚙 齕
꺼릴	꺼릴 忌 憚 諱
꺼질	꺼질 消
꺽을	꺽을 拉 拉 挫 剉
꺾을	꺾을 拉 拉 拗 折 挫 摧 貶
껍질	껍질 殼 皮
꼬리	꼬리 尾 巴
꼽추	꼽추 佝
꽂을	꽂을 揷 拵 搢
꽃밥	꽃밥 葯
꽃술	꽃술 蘂 蕊
꽃잎	꽃잎 瓣
꾀일	꾀일 誘
꾀할	꾀할 企 謀 詢 惟 議 諏 度 誧
꾸릴	꾸릴 包
꾸밀	꾸밀 扮 修 飾 妝 鎣 餼
꿰맬	꿰맬 縫 綴 總 緶 匧
꿰멜	꿰멜 綴
끄을	끄을 裊
끈목	끈목 絙
끊을	끊을 決 斷 刎 泆 絶 切 截 劗 切 祝
끌릴	끌릴 惹
끌채	끌채 輈
끓을	끓을 涫 沸 沄 湯
끝날	끝날 完 酋
끝낼	끝낼 終
끼니	끼니 時
끼일	끼일 窄
끼칠	끼칠 遺 貽
나귀	나귀 驢
나눌	나눌 件 另 班 頒 攽 肦 擘 別 部 分 疏 厮 異 派 捌 携
나라	나라 國 邦 土
나루	나루 濟 津
나무	나무 木 樹 椄
나물	나물 芼 蔬 菜
나비	나비 蜨
나쁜	나쁜 兇
나쁠	나쁠 歉 惡
나올	나올 吐
나을	나을 優 愈
나이	나이 齡 鹷 壽 齒
나중	나중 結
나팔	나팔 叭
낙지	낙지 鮹
낙타	낙타 駱 駱
낚시	낚시 釣 鈟 筩
낚을	낚을 絅
난간	난간 欄 欄 楯 檻
난삼	난삼 襴
난새	난새 鸞 鸞
난초	난초 蘭 蘭 蕙
낟알	낟알 顆
날개	날개 翎 翅 翼 翰
날랠	날랠 敢 姚 勇 票 嫖 驍 仡
날릴	날릴 嫋 颺
날쌜	날쌜 驃
날칠	날칠 涌 攄
남기	남기 嵐 嵐
남길	남길 垂
남녘	남녘 南 丙
남을	남을 藎 餘 余 遺 剩
남쪽	남쪽 午
납향	납향 臘 臘 蜡
낮을	낮을 卑 低 氐
낳을	낳을 産 乳 緝 出
내관	내관 寺
내기	내기 賭
내릴	내릴 降 殺
내시	내시 豎 閹 巷
내칠	내칠 蔡 泄 斥 黜 罷 廢
냄새	냄새 腥 臭
냉소	냉소 嗤
냉이	냉이 薺
너무	너무 已
널리	널리 彌 普
넓을	넓을 廣 宏 漭 博 磐 旁 普 衍 瀇 侈 誕 坦 灝 洪 闊 弘 恢
넓이	넓이 積
넓힐	넓힐 演 擴
넘을	넘을 越 踰
넘칠	넘칠 瀲 氾 洋 盈 淫 溢 漲 碭 汰 洫
넙치	넙치 鰈
노끈	노끈 繩
노닐	노닐 徘 徜 逍 遨 遙 游 徨 徊
노래	노래 歌 哥 謳 謠 唱
노루	노루 獐 麞
노름	노름 賭
노새	노새 騾
노수	노수 贐
노을	노을 霞
노인	노인 眉 爺
노자	노자 贐
노적	노적 庾
노할	노할 愾 僩 嚇
녹봉	녹봉 寀
녹슬	녹슬 銹
녹용	녹용 茸
녹을	녹을 銷 溶
녹일	녹일 鑠 銷 煬 烊 鎔 溶
놀랄	놀랄 驚 戇 啞 愕 咢 噩 傽 慫 唇 猖 駭
놋쇠	놋쇠 鉐 鍮
농기	농기 梢
농막	농막 墅 庄
농부	농부 畯
농사	농사 農
농어	농어 鱸
높을	높을 高 僑 喬 穹 貴 岌 岐 隆 卲 崇 嵩 巍 隗 堯 嶢 危 岑 尊 峻 埈 嶄 敞 嶕 卓 亢 顯
높일	높일 竦 颺 右
놓을	놓을 擱 居 放 稅 堆
뇌물	뇌물 賂 財 賄
뇌사	뇌사 誄
누구	누구 誰 孰
누룩	누룩 麴
누를	누를 捺 攏 撫 壓 押 抑 撙 鎭 黃
누리	누리 雹 螽 蝗
누릴	누릴 臊 嚮
누에	누에 蠶 蚕
누울	누울 偃 臥
누이	누이 妹
누일	누일 湅
눈꽃	눈꽃 霙
눈물	눈물 淚 淚 洟 涕
눈썹	눈썹 眉
눌릴	눌릴 尉
느낄	느낄 感 觸
느릴	느릴 禹 怠
늑대	늑대 豺
늘미	늘미 材
늘일	늘일 縯
늙을	늙을 耉 老 台
능에	능에 鴇
능할	능할 能 才 就
늦을	늦을 晩 晏 遲 稚
늦출	늦출 弛
다닐	다닐 通 行
다락	다락 樓 樓
다를	다를 另 異 殊 外 異 他 佗
다리	다리 脚 橋
다릴	다릴 煎
다만	다만 但 只 特
다목	다목 枋
다섯	다섯 五
다시	다시 更 更 復
다질	다질 築 夯
다칠	다칠 痍 戧
다툴	다툴 競 爭
다할	다할 竭 闋 竟 窮 消 澌 盡 殄 殫 破 蔽 畢 乏 虛 歇
닥칠	닥칠 迫
닦을	닦을 抆 撲 修 脩 拭 飭
단비	단비 澍
단술	단술 醴
단지	단지 壺 瓠
단추	단추 紐 靵
닫을	닫을 閉 闔
달래	달래 蒜
달랠	달랠 說
달릴	달릴 赶 騖 赴 奔 騁 駛 走 驟 馳
달빛	달빛 皎 波
달일	달일 煎
닮을	닮을 肖
담글	담글 淹 漬
담벽	담벽 墉
담비	담비 貂
담을	담을 盛 受
담제	담제 禫
답다	답다 哉
당길	당길 牽 抉 控 輦 挽 挻 曳 拽 掜 援 爰 誘 揄 撮 抽 拖 拕
당할	당할 見 膺 抵 牴 充 値
닻돌	닻돌 碇
닻줄	닻줄 纜
닿을	닿을 延 搶 屬
대강	대강 綱 槪 率 牴
대개	대개 槪 梗
대공	대공 檼
대구	대구 銙 鰵
대궁	대궁 餕
대궐	대궐 甲 闕 宸 魏 殿
대낮	대낮 旿
대답	대답 答
대략	대략 約
대모	대모 玳 瑁
대문	대문 闥
대밭	대밭 篁
대숲	대숲 篁
대싹	대싹 筍 笌
대야	대야 盥
대접	대접 視
대쪽	대쪽 簡 筳
대청	대청 筟 桭
대통	대통 管
대패	대패 釿 鏟 鉋
댓닭	댓닭 鵾 鶤 鶸
더딜	더딜 緩 遲 娧
더욱	더욱 尤 愈
더울	더울 煖 暑 曣 熱 燠
더할	더할 加 俾 埤 施 嬰 益 增 添 沾 佗
던질	던질 擲 槌 投
덜릴	덜릴 瘳 貶
덤불	덤불 藪
덤빌	덤빌 悤
덥힐	덥힐 被
덧널	덧널 槨
덧옷	덧옷 褶
덩굴	덩굴 蔓
덩이	덩이 錠
덮개	덮개 蓋
덮게	덮게 套
덮을	덮을 蓋 巾 冪 幪 幎 藩 庇 蔭 廕 被 盍
덮일	덮일 燾
데칠	데칠 炡
도끼	도끼 斧 鈇 鉞
도덕	도덕 典
도둑	도둑 寇 盜 賊
도랑	도랑 渠 瀆 窪 渟
도마	도마 俎
도미	도미 鯛
도울	도울 介 幇 幫 保 補 輔 俌 扶 裨 毗 贍 承 丞 襄 倪 右 佑 祐 宥 侑 戎 翊 奬 助 佐 佽 贊 誧 弼 協 挾
도읍	도읍 都
도장	도장 璽 印 閤
도적	도적 賊
도포	도포 襖 褒 袍
도표	도표 栞
독할	독할 毒 酷
돈대	돈대 墩
돈피	돈피 貂
돋울	돋울 挑
돋을	돋을 挑
돌릴	돌릴 斡
돌침	돌침 砭
돌피	돌피 稗
동개	동개 鞬
동관	동관 僚 寮 僚 寀
동네	동네 坊
동녘	동녘 東
동록	동록 銹
동료	동료 僚
동배	동배 儕
동부	동부 豌
동산	동산 園
동서	동서 姒 妯
동이	동이 盆 盎
동자	동자 侲
동포	동포 胞
돛대	돛대 橈 檣 楫
돼지	돼지 豚 豕 猪 豬 彘 亥
된죽	된죽 飦 餰
두공	두공 栱 枓
두렁	두렁 陌 阡
두루	두루 彌 旁 巡 周 遍
두를	두를 摽 圜
두목	두목 酋 覇
두풍	두풍 瘋
둔덕	둔덕 陼
둔할	둔할 駑 鈍
둘레	둘레 廓 圍 廓
둘릴	둘릴 繞 遶 纏 繯 浹
둥글	둥글 圈 團 侖 圓 員 丸
뒤칠	뒤칠 飜
뒷간	뒷간 圊 厠 廁 圂
드릴	드릴 饈 致 享 獻
드물	드물 疎 疏 罕 稀
들개	들개 犴 狴
들깨	들깨 蕡 荏
들랠	들랠 呶
들릴	들릴 聕
들보	들보 梁 樑 椋 莛
들불	들불 燒
들을	들을 聆 聞 听 聽
들일	들일 納
들창	들창 牖
들판	들판 野 埜 原
등걸	등걸 榾
등급	등급 級
등불	등불 熒
등사	등사 螣
등자	등자 鐙
등잔	등잔 燈
등창	등창 癕 疽
따를	따를 隨 繇 依 酌 追
딸기	딸기 苺
딸릴	딸릴 孺
때릴	때릴 拷 毆 打
땜납	땜납 鑞
떠날	떠날 離 仳 携
떠들	떠들 躁 咻
떡국	떡국 托
떡잎	떡잎 傑
떨기	떨기 叢 朶
떨릴	떨릴 惏
떨칠	떨칠 奮 拂 振
떫을	떫을 澁
뗏목	뗏목 槎
똬리	똬리 藪
뚜껑	뚜껑 弇 蓋 盖 榼
뚫릴	뚫릴 疏 通
뚫을	뚫을 鑿 鑽 穿
뛰놀	뛰놀 獗
뜨물	뜨물 潘
띠끌	띠끌 塵
띠술	띠술 綎
띠싹	띠싹 荑
롱할	롱할 戱
마개	마개 桁
마구	마구 槽
마귀	마귀 魔
마노	마노 瑙 瑪 碼
마늘	마늘 葫
마당	마당 場
마디	마디 節 寸
마루	마루 宗
마를	마를 乾 竭 枯 槀 脩 萎 燥 蘀 暴 涸 炕 烜 晞
마름	마름 芡 菱 菱 蔆 蘊 薀 萍 蓱
마리	마리 頁
마마	마마 痘 疹
마부	마부 厮 廝 娠 圉 騶
마실	마실 喫 歃 飮 啜 歠 哈
마을	마을 洞 里 府 署 衙 閻 塢 村 邨 陬 巷
마음	마음 性 心 衷
마치	마치 錘 恰
마칠	마칠 結 竟 了 成 崇 熄 傮 終 竣 閉 畢
마침	마침 昉 適 祇
막대	막대 梃 棖
막을	막을 拒 揵 隔 杜 攔 防 樹 戍 遏 礙 捱 禦 壅 衞 堙 障 抵 沮 敵 窒 遮 充 捍 抗 迥 冱
막힐	막힐 泥 塞 阨 咽 邕 濡 障 塡 阻 滯
만날	만날 見 遘 姤 罹 逢 晤 迕 遇 遭 値 逅
만두	만두 饅
만들	만들 製 做
만물	만물 物
만약	만약 若 如
만자	만자 卍
많을	많을 巨 夥 多 繁 詵 盛 毓 殷 溱 侈 海 薨
맏길	맏길 信
맏이	맏이 兄
말뚝	말뚝 栓
말리	말리 莉 茉
말릴	말릴 焙 暵
말몰	말몰 驟
말씀	말씀 談 辭 詞 說 說 語 言 說
말탈	말탈 騎 驀
말할	말할 論 論 誦 議 話
맑을	맑을 潔 漌 澹 洌 瀏 潾 偰 淑 淳 泚 渽 淨 晶 瀞 澄 瀓 澯 淸 測 瀅 滎 淏
맛볼	맛볼 嘗 甞
망루	망루 闇
망치	망치 杵
망할	망할 亡 泯 摧
맞설	맞설 拒
맞을	맞을 迎 邀 這 協
맡길	맡길 肩 隨 委 任 託
맡을	맡을 堪 司 任 典 判 嗅
매괴	매괴 玫
매길	매길 課
매달	매달 懸
매미	매미 蟬 蜩
매양	매양 每
매우	매우 霉
매울	매울 苛 辣 烈 辛 烈
맨발	맨발 跣
맵시	맵시 姿
맷돌	맷돌 碾 磑
맹금	맹금 鷙
맺을	맺을 結 契 繫 約 維 縝 綴 締
머리	머리 腦 頭 首 頁
머물	머물 宿
머슴	머슴 雇 傭
먹을	먹을 食 咀 餐 噍 餔
먹일	먹일 饋 飼 餧 餌 哺 餉
먼저	먼저 先 首
먼지	먼지 垢 坌 埃
멈출	멈출 宁
멍에	멍에 駕 轅
멍울	멍울 腺 癤
멍할	멍할 惘 惝 怳
메기	메기 鮎 鯷
메밀	메밀 蕎
메벼	메벼 粳
메일	메일 塡
메주	메주 豉
멧동	멧동 岡
며루	며루 螟
면할	면할 甄 免
멸치	멸치 鰯 鰮
멸할	멸할 滅 殲 翦 呑
명령	명령 令
명예	명예 聲
명주	명주 紬 縞
명치	명치 膈
명협	명협 蓂 莢
모기	모기 蚊 蚋
모낼	모낼 移
모두	모두 皆 悉 亦 諸 咸 該
모든	모든 諸
모뜰	모뜰 搭
모래	모래 沙 砂
모루	모루 鑕
모모	모모 乙
모범	모범 樣 則
모시	모시 縕 苧 紵
모실	모실 陪 侍 御
모양	모양 貌 樣 儀 態 風 形
모을	모을 兼 募 裒 收 蒐 積 際 綜 集 輯 纂 儹 屬 叢 摠 揫 蓄 萃 聚 冣 會 彙
모일	모일 社 簇 輳 湊 寯 集 攢 欑 儧 兌 會
모자	모자 帽
모직	모직 榻
모질	모질 稜 悍
모탕	모탕 椹
목뒤	목뒤 項
목맬	목맬 絞 雉
목멜	목멜 哽 咽
목수	목수 梓
목숨	목숨 命 壽
목어	목어 梆
목장	목장 駉
목칼	목칼 枷
목탁	목탁 鐸 柝
목화	목화 棉
몰래	몰래 暗 陰
몸메	몸메 匁
몸소	몸소 身 親
몹시	몹시 痛
못할	못할 猱 劣 叵
묘할	묘할 妙
무늬	무늬 文 紋 彩
무당	무당 巫
무덤	무덤 墓 培 墳 塋 塚
무딜	무딜 鈍
무릇	무릇 凡
무릎	무릎 膝
무리	무리 群 黨 徒 等 黎 類 們 物 輩 屬 伍 偶 暈 殷 敵 曹 儔 衆 摠 醜 偏 匹 暈 彙
무소	무소 犀
무엇	무엇 渠 誰 甚
무우	무우 蔔
묵을	묵을 陳
묶을	묶을 鞏 括 累 累 繆 縛 繃 束 纏 紮 揫 絜 傒
묶일	묶일 囚
문득	문득 便 奄 輒 便 溘 欻
문뜩	문뜩 奄
문미	문미 楣
문서	문서 券 簿 籍 帖 票
문어	문어 鮹
문짝	문짝 扉 闔
문채	문채 章 彪
문테	문테 框
묻을	묻을 坑 埋
물가	물가 氿 磯 濱 瀕 浜 澨 洙 潯 涯 厓 漄 芮 渚 汀 渟 洲 沚 浿 浦 滸 涍
물개	물개 肭
물결	물결 浪 濤 瀾 浪 瀨 波
물댈	물댈 淋 淋 注
물돌	물돌 匯
물릴	물릴 饜 飽
물미	물미 錣
물쑥	물쑥 蔞
물을	물을 齦 問 詢 訊 憖 諮 咨 偵 諏 候 詰
물읾	물읾 洙
물치	물치 鰹
물통	물통 榼
묽을	묽을 淡
뭉갤	뭉갤 點
뭉치	뭉치 侖
미끼	미끼 餌
미눌	미눌 距
미리	미리 豫 預
미쁠	미쁠 孚 誠 允
미음	미음 漿 粥
미질	미질 狂
미칠	미칠 瘈 狂 及 扱 覃 與 延 癲 倀 逮 迨 被
믿을	믿을 亶 諒 孚 洵 詢 恂 恃 信 諶 諒 兗 尹 倚 恁 忱 怙
밀칠	밀칠 排 挨 攘 抵 拓 托
밑둥	밑둥 樞 苞
바깥	바깥 外
바꿀	바꿀 改 貿 易 易 替 兌 換
바늘	바늘 箴 針 鍼
바다	바다 溟 海
바둑	바둑 棋 碁 奕
바디	바디 筬
바라	바라 刁
바랄	바랄 觖 冀 覬 抹 望 願 幸 希
바람	바람 飉 風
바룰	바룰 匡
바를	바를 衎 格 匡 佶 塗 董 抹 是 尹 正 廷 剔 敕 平
바리	바리 盂 盔
바림	바림 渲
바쁠	바쁠 忙 宂 悤
바위	바위 巖 岩 嵓 礒
바지	바지 褰 袴
바치	바치 匠
바칠	바칠 貢 納 示 獻
바퀴	바퀴 轂 輪 蜚
바탕	바탕 性 素 才 質
박공	박공 牔
박달	박달 枋
박수	박수 覡
박을	박을 搭
박쥐	박쥐 蝠 蝙
반계	반계 磻
반달	반달 弦
반석	반석 磐
반야	반야 若 若
반찬	반찬 膳 饍 饈 饌 餚
받들	받들 擧 巹 戴 奉 捧 承 詩
받을	받을 受 茹 膺 觝 觸 取 稟 禀 嚮 歆
발등	발등 跗
발할	발할 開
밝을	밝을 鑑 昛 甄 蠲 暻 杲 曠 炚 暞 昑 朗 旦 朗 亮 瞭 暸 明 昉 炳 昺 毘 昞 毗 晳 晰 晟 昭 炤 昻 瑩 睿 叡 晤 旿 牖 融 焯 暲 的 晢 靚 晙 彰 昶 哲 喆 埑 晫 洞 表 赫 顯 炫 炯 熒 瑩 晧 皞 晃 愰 晄 熹 熺
밝힐	밝힐 述 信 闡 寭
밟을	밟을 踏 蹈 躐 履 跋 躡 蹂 蹠 踐 蹴 跆
밥통	밥통 肚 胃
방게	방게 螃 蟛
방계	방계 蜝
방광	방광 胱 膀
방귀	방귀 屁
방아	방아 碓
방어	방어 魴
방울	방울 鑾 鈴 鈸
방위	방위 方 位
방죽	방죽 堰
방축	방축 堤
방패	방패 干 櫓 盾 楯 牌 彭
방합	방합 蚌
밭갈	밭갈 耕 耭 佃
밭을	밭을 淥
밭집	밭집 村
배꼽	배꼽 脖 臍
배댈	배댈 泊
배울	배울 學
배추	배추 菘
배필	배필 伉
백년	백년 世
백반	백반 礬
백성	백성 氓 民 姓 元
백지	백지 芷
백토	백토 墡
뱁새	뱁새 鷦
뱃길	뱃길 港
뱃전	뱃전 舷
버금	버금 副 倅 亞 貳 儲 仲 次 簉 廁
버들	버들 柳
버릇	버릇 慣 癖 俗
버릴	버릴 去 棄 拌 捨 捎 施 捐 委 諉 已 擲 致 置 唾 投 播 敝 抛
버선	버선 靺 襪
버섯	버섯 菌 圥 栮
버짐	버짐 癬
버틸	버틸 梧 撑 撐
번개	번개 電 霆
번수	번수 番
번질	번질 漸 浸
번철	번철 鏊
벌레	벌레 蟲 虫 虫
벌릴	벌릴 編 布 鋪
벌써	벌써 業
벌일	벌일 列 列
벌줄	벌줄 罰
벌판	벌판 坪
범벅	범벅 飦
범어	범어 梵
범위	범위 域
범할	범할 奸 犯 淬 觸 侵
법도	법도 度 儀 度
법랑	법랑 琺
법령	법령 甲
법식	법식 例 例
법칙	법칙 則
벗길	벗길 剺 剝
벗을	벗을 褫 脫 解
베개	베개 枕
베게	베게 枕
베낄	베낄 謄 摹 寫 抄 搨
베일	베일 葪 殊 劓 荑
베틀	베틀 機
베풀	베풀 開 供 敷 敍 宣 設 施 矢 繹 夷 張 置 襯 布 鋪
벼락	벼락 靂 霹 霆 震
벼루	벼루 硯 陬
벼룩	벼룩 蚤
벼리	벼리 綱 紀 維 統
벼슬	벼슬 監 卿 官 士 位 爵 職 宦
벽돌	벽돌 甓 塼 磚 甎
벽옹	벽옹 廱
변망	변망 塞 塞
변방	변방 疆 塞 垂 陲 圉 裔 徼
변할	변할 變 移 轉 忒 幻
볏단	볏단 筥
볏줄	볏줄 牽
볏집	볏집 稿
볏짚	볏짚 稈 秸 穰
병거	병거 轒
병들	병들 病 癒 塡
병부	병부 符
병풍	병풍 屛 依 邸 風
보낼	보낼 遣 送 輸 媵 餞 贈 致 派
보뚝	보뚝 埭
보람	보람 驗
보루	보루 城
보리	보리 稞 麥
보배	보배 寶 鈺 玩 財 珍 鉁 琛
보살	보살 菩 薩
보석	보석 琬
보습	보습 鑱
보일	보일 示 呈 出 見
복도	복도 廊 廊 巷
복령	복령 茯
복자	복자 鐥
복토	복토 輹
복희	복희 羲
볶을	볶을 熬 炒
볶일	볶일 炭
본뜰	본뜰 摸 倣 楷
볼기	볼기 臀
봉새	봉새 鳳
봉선	봉선 禪
봉할	봉할 檢 縢 封 緘
봉화	봉화 爟 烽 燧
봉황	봉황 鷖
뵈올	뵈올 謁
부고	부고 訃
부두	부두 埠
부레	부레 鐪 鰾
부루	부루 萵
부를	부를 叫 召 速 要 邀 徵 招 吹 呼 喚
부리	부리 嘴 觜 喙
부릴	부릴 徇 厮 廝 役 徭
부분	부분 局
부상	부상 榑
부세	부세 租
부술	부술 碎
부신	부신 符
부아	부아 肺
부엌	부엌 竈 廚 庖
부용	부용 芙
부을	부을 酹
부의	부의 賻
부자	부자 富
부채	부채 扇
부처	부처 佛
부추	부추 韭 薤
부칠	부칠 客 寄 煽 授 掜
부풀	부풀 疱
부피	부피 積
북녘	북녘 北
분낼	분낼 怨
분별	분별 別
분할	분할 慨 憤 忿 悁
불김	불김 烱 熇
불깔	불깔 騸
불꽃	불꽃 燮 炎 煜 煥
불땔	불땔 焌 爨 炊
불똥	불똥 燼 炭
불릴	불릴 鍊 煉 殖 鎔 浸
불빛	불빛 爀 炫
불알	불알 勢 腎
불을	불을 滋 增 漲
불탈	불탈 燃
붉은	붉은 緋
붉을	붉을 丹 丹 赤 朱 熛 紅
붕산	붕산 硼
붕어	붕어 鮒
붙들	붙들 扶
붙을	붙을 隷 隸 附 着 貼
붙이	붙이 屬
붙일	붙일 屬 粘 黏 椄 貼 贅
비갤	비갤 霽
비결	비결 訣 讖
비계	비계 肪 脂
비길	비길 掜 擬 攄 攇
비낄	비낄 斜
비녀	비녀 筓 簪 鈿 釵 釵
비늘	비늘 鱗 鱗
비단	비단 絹 繭 錦 綺 緞 綾 帛 繒 綵 貝
비록	비록 雖
비밀	비밀 祕 奧
비비	비비 狒
비상	비상 砒
비석	비석 碑
비수	비수 匕 鏢
비올	비올 霅
비위	비위 脾
비출	비출 照
비취	비취 翠
비칠	비칠 鑑 燾 映 暎 燿 煜 晢 照 爥 撮 曯
비탈	비탈 嶝 陀 陘
비틀	비틀 撚 捻 捩
비파	비파 琵 瑟 筑 琶
비해	비해 萆
비휴	비휴 貔
빈대	빈대 蝎
빌릴	빌릴 貸 貰 賃 借 徣
빌미	빌미 祟
빗날	빗날 炅
빗을	빗을 刷
빗장	빗장 扃 關
빚질	빚질 債
빛날	빛날 炅 耿 烱 冏 熲 彬 斌 爍 曄 映 煐 耀 燿 旭 煜 彧 熊 暐 熤 晶 燦 璨 濯 熛 赫 爀 奕 炯 逈 晧 焜 華 煥 奐 煌 輝 煇 熙 凞
빠를	빠를 偈 牽 霍 适 亟 撻 速 殺 夙 徇 侚 迅 糴 倢 促 快 剽 儇
빠질	빠질 坑 溺 淪 湎 沒 泯 墊 浸 湛 陷
뻗칠	뻗칠 亙
뼈골	뼈골 髓
뼈대	뼈대 腔
뽑을	뽑을 募 揠 抽 擢
뿌리	뿌리 根 柢 土
뿌릴	뿌릴 潑 撒 灑 擦
뿔심	뿔심 鰓
뿔잔	뿔잔 觳 觥
뿜을	뿜을 噴 吩 濆 咤 噓
사고	사고 宬
사공	사공 舫
사과	사과 苹
사귈	사귈 交 接 通
사기	사기 史
사내	사내 男 郞
사냥	사냥 獵
사당	사당 廟 祠
사돈	사돈 親
사람	사람 人
사랑	사랑 愛
사뢸	사뢸 禀
사를	사를 灼
사마	사마 駟
사막	사막 漠
사발	사발 甌 椀
사사	사사 私
사슴	사슴 鹿 鹿
사신	사신 价 佋 信
사업	사업 勣
사위	사위 甥 壻 婿
사이	사이 間 際
사자	사자 獅 狻 猊 麑
사적	사적 蹟
사지	사지 肢
사처	사처 邸
삭일	삭일 繹 酵
산길	산길 岪
산소	산소 塋
산신	산신 离
산자	산자 橵 餦
산중	산중 疝
산증	산증 疝
산호	산호 珊 瑚
살갗	살갗 臚 膚
살결	살결 腠
살구	살구 杏
살별	살별 欃
살쩍	살쩍 鬢
살찔	살찔 膏 膩 肥 膆 膃 濯
살필	살필 監 甄 糾 省 省 誠 孰 諟 審 按 要 在 狙 展 察 諦 必
삶는	삶는 烹
삶을	삶을 鬺 熟 燖 煮 汋 宰 烹
삼갈	삼갈 恪 慤 惓 謹 兢 毖 損 醇 愼 愿 碏 敕
삼실	삼실 縝
삼킬	삼킬 飡 餐 呑
삽주	삽주 薊 葪
삿갓	삿갓 笠 笠
상말	상말 諺
상복	상복 縗
상사	상사 喪
상서	상서 瑞
상어	상어 鮫 鮪
상여	상여 楯
상옷	상옷 縗
상자	상자 匣 櫃 笥 箱 衍 函 篋
상줄	상줄 賞
상처	상처 傷
상추	상추 苣 萵
상투	상투 髻 掃 墮
상할	상할 傷 損 危 夷 痍 痛 暴
새길	새길 刻 鏤 銘 鈒 鐫 彫 鋟
새매	새매 鷂 隼
새벽	새벽 昧 曙 晨 旴 早 曉
새싹	새싹 蓐
새알	새알 蛋
새앙	새앙 薑
새우	새우 鰤 蝦 鰕
새장	새장 笯
새집	새집 巢
새털	새털 氅
색시	색시 閨
색욕	색욕 性
샘낼	샘낼 嬲
샛별	샛별 晨 皖
생각	생각 念 憶 意
생강	생강 薑
생선	생선 鱻
생질	생질 甥 出
생초	생초 素
생황	생황 笙 簧
서녘	서녘 西
서당	서당 塾
서로	서로 相 胥 互
서른	서른 卅
서리	서리 霜
서릴	서릴 蟠
서안	서안 桯
서옥	서옥 圭 珪 瑁 璲 琬 璋 璜
서울	서울 京 城
서쪽	서쪽 楡
서캐	서캐 蟣
서툴	서툴 拙
석서	석서 鼫
석수	석수 宕
섞을	섞을 斁 混 朽
섞일	섞일 猥 糅 雜 錯 厠 廁 混 殽
선비	선비 士 彦 儒
선창	선창 埠 艙
설렐	설렐 螴
설사	설사 痢
섬돌	섬돌 階 堦 除 砌
성곽	성곽 郭
성길	성길 疎 疏 麤
성낼	성낼 愾 譴 怒 怒 奮 忿 恚 噁 慍 讉 嗔 熛 哮
성냉	성냉 怒
성시	성시 星
성씨	성씨 姜 聶 蘇 邵 卲 宋 繡 順 荀 薪 鄴 悅 葉 潁 嬴 芮 吳 阮 隗 禹 芸 袁 阮 胃 韋 蔿 伊 籛 鄭 崔 秋 卓 彭 片 鮑 馮 皮 夾
성인	성인 聖
성조	성조 仄
성품	성품 性 材 稟 禀
성할	성할 祁 繁 盛 殖 衍 旺 繇 煜 溱 泡 鑣 赫 熹 憙
세간	세간 傢 什
세계	세계 海
세금	세금 稅
세낼	세낼 貰
세대	세대 葉
세로	세로 縱
세상	세상 世 俗
세울	세울 建 樹 竪 豎 植 尌
세월	세월 星 陰 秋
세찰	세찰 烈
셈대	셈대 籌
소경	소경 瞽 盲 矇 瞍
소고	소고 鞀
소금	소금 鹵 鹽
소라	소라 螺 螺
소로	소로 逕
소리	소리 聲 音 喊
소매	소매 袪 袂 袖
소목	소목 昭
소문	소문 謠
소반	소반 盤
소식	소식 便
속곳	속곳 衷
속대	속대 苠
속될	속될 俚
속세	속세 埃
속옷	속옷 袢 襯
속일	속일 誑 誆 拐 詭 伋 欺 倰 瞞 謾 誣 詐 佯 僞 侜 誕 騙 懗 諼 譎
손님	손님 客
손병	손병 据
손자	손자 孫
손톱	손톱 爪
솔개	솔개 鳶 鴟 鵄
솜털	솜털 毳
솟을	솟을 竦 聳 擢
송곳	송곳 錐
송어	송어 鱒
송장	송장 屍
솥귀	솥귀 鉉
쇠뇌	쇠뇌 弩
쇠북	쇠북 鐘
쇠할	쇠할 衰 頹
쇳돌	쇳돌 鑛 磺 鉒
수갑	수갑 梏 丑 杻 桁
수건	수건 巾 幡
수달	수달 獺
수량	수량 額
수렁	수렁 汀
수레	수레 軻 車 輛 輅 車 軺
수리	수리 鵰
수말	수말 騭
수삼	수삼 枲 絪
수양	수양 羘
수염	수염 須 鬍
수유	수유 茱 萸
수은	수은 汞
수은	수은 澒
수저	수저 柶
수정	수정 瑛 晶
수종	수종 瘇
수치	수치 汶
수컷	수컷 牡 雄
수풀	수풀 林
숙일	숙일 低 佔
순라	순라 徼
순풀	순풀 荀
순할	순할 孫 遜 順 婉 柔 迪
술괼	술괼 酵
술독	술독 罍
술밑	술밑 酶
술법	술법 術
술병	술병 壜 罌 罃 酲 鍾
술잔	술잔 觚 蜃 鍾 卮 叵
술통	술통 椑 彝
숨길	숨길 沕 秘 廋 匽 竄
숨쉴	숨쉴 匿 息 吹
숨을	숨을 匿 遯 蒐 幽 隱 竄 避
숫돌	숫돌 礪 砥
숫소	숫소 特
숫양	숫양 羝
숭어	숭어 鯔
쉬울	쉬울 易 平
스물	스물 卄
스물	스물 廿
스밀	스밀 瀝
스승	스승 傅 師
슬갑	슬갑 褶 韠 鞸
슬기	슬기 智
슬플	슬플 慨 悲 哀 嗟 慘 惻 咤 恫 噫
습병	습병 痿
시가	시가 町
시각	시각 晷
시골	시골 村 鄕
시내	시내 溪 谿
시동	시동 尸
시들	시들 凋
시렁	시렁 架 庋 棚 桁 桁
시루	시루 甑
시월	시월 陽
시위	시위 弦
시작	시작 胎
시장	시장 行
시집	시집 媤
시체	시체 屍 尸
시초	시초 耑 蓍
시킬	시킬 令
시호	시호 諡
식혜	식혜 醯
신골	신골 楥
신령	신령 靈 精
신명	신명 神
신선	신선 仙
신세	신세 恩
신시	신시 晡
신하	신하 臣
실과	실과 果 核
실밑	실밑 紇
실을	실을 載 縡
싫은	싫은 翫
싫을	싫을 慊 饜 翫
심을	심을 稼 建 樹 植 殖 藝 栽 播
심지	심지 炷
심할	심할 劇 甚 太 痛
싸리	싸리 杻
싸울	싸울 鬩 鬨
싸움	싸움 戰 鬪
쌀알	쌀알 粒 粒
쌀일	쌀일 淅
쌍배	쌍배 膀 航
쌍옥	쌍옥 珏
쌍희	쌍희 囍
쌓을	쌓을 居 蘊 隱 貯 儲 褚 積 築 畜 聚 冣 峙 蓄
쌓일	쌓일 蘊 薀 戔 滯
써레	써레 杷
썩을	썩을 腐 朽
썪을	썪을 黴 臭 敗
쏙갓	쏙갓 茼
쏟을	쏟을 瀉 輸
쏠릴	쏠릴 靡 熱
쐐기	쐐기 櫼
쓸개	쓸개 膽
씨름	씨름 鷰 觝 牴
씨줄	씨줄 緯
씹을	씹을 啖 啗 噉 噬 齧 食 嚼 咀
씻길	씻길 汰
씻을	씻을 漑 汏 濾 洗 洒 拭 浣 湔 澡 滌 濯 湯 盪 燙
아교	아교 膠
아귀	아귀 鮟
아낄	아낄 慳 靳 吝 悋 嗇 薔 惜 隱 吝
아내	아내 配 嬪 室 妻
아닐	아닐 勿 未 不 否 不 弗 非
아들	아들 吾 子
아래	아래 下
아뢸	아뢸 謁 奏
아무	아무 某
아비	아비 爹 父 耶 爺 爸
아씨	아씨 孃
아우	아우 弟
아욱	아욱 葵
아이	아이 童 僮 兒
아전	아전 掾
아청	아청 紺
아침	아침 旦 朝 晁 昕
아플	아플 疼 側 惻 痛 恫 鋪
아홉	아홉 九
악공	악공 伶
악기	악기 響
악어	악어 鰐
악할	악할 惡 惡 痓
안갑	안갑 鞁
안개	안개 雺 霧 雰
안방	안방 閨
안석	안석 几
안을	안을 擁 抱
안장	안장 鞍
안주	안주 肴
앉을	앉을 居 坐
알릴	알릴 告 問 愬 訊 喩
알몸	알몸 倮
앓을	앓을 疴 恫
암말	암말 騍
암삼	암삼 苴
암소	암소 牯
암양	암양 牂
암자	암자 庵 菴 蓭
암초	암초 礁
암컷	암컷 牝 雌 牸
앙금	앙금 淤 浧 滓
앞섶	앞섶 袍
애밸	애밸 胎
야윌	야윌 顦
약대	약대 駝
약을	약을 黠
약포	약포 腶
약할	약할 衰 弱 藥 窳 脆 虛
얇을	얇을 軸
양식	양식 糧 粮
양하	양하 蘘
얕을	얕을 竊 淺
어길	어길 迕 違 差 避
어깨	어깨 肩 膊
어느	어느 孰
어른	어른 叟 丈 正
어릴	어릴 蒙 小 叔 弱 嬰 倪 幺 幼 毓 沖 冲 稚 齔
어망	어망 罾
어미	어미 媽 母
어제	어제 昨
어질	어질 良 叡 昷 愈 仁 賢
어찌	어찌 曷 豈 那 奈 奈 柰 安 焉 烏 何 奚
어채	어채 鮭
억셀	억셀 橿 迅
언덕	언덕 堈 皐 丘 邱 坵 壟 壟 坏 阜 埽 阿 厓 原 垠 圻 陼 阤 堆 坡 阪 坂
얻을	얻을 得 受 有 獲
얼굴	얼굴 貌 顔 容
얼룩	얼룩 文 斑
얼마	얼마 所
얼음	얼음 凌 氷
얽을	얽을 綰 繆 絆 紹 纏
얽힐	얽힐 紊 纓 縈 繞 紆 糅 綢 繯
엄쪽	엄쪽 券
엄할	엄할 嚴 莊
없앨	없앨 剔
없을	없을 莫 罔 蔑 耗 無 无 乏
엉길	엉길 凝
엔담	엔담 囿
여관	여관 亭
여기	여기 于 這
여뀌	여뀌 蓼 蓼 芫
여덟	여덟 八
여돌	여돌 礖
여러	여러 庶
여름	여름 夏 昰
여물	여물 莝
여섯	여섯 六
여승	여승 尼
여우	여우 狐
여울	여울 湍 瀨 灘
여윌	여윌 癯 羸
여종	여종 婢
여쭐	여쭐 稟 禀
역마	역마 馹
역말	역말 郵 馹 置
역사	역사 史
엮을	엮을 編
연고	연고 故
연기	연기 煙
연꽃	연꽃 蕖 蓮 芙 蓉 荷
연못	연못 塘 汪
연밥	연밥 蓮 薏 菂
연어	연어 鰱
연지	연지 臙 巵 卮
연할	연할 連 聯 軟 韋 脆
열릴	열릴 展 拆
열매	열매 實
열쇄	열쇄 鍵
열쇠	열쇠 鍵 匙 鍉
열흘	열흘 旬
엷을	엷을 濂 薄 菲 俴 偸
염교	염교 薤
염병	염병 疫 瘟
염지	염지 盬
염할	염할 殮 殯 殮
엿볼	엿볼 窺 竅 伺 覗 時 狙 佔 偵 覷
영양	영양 羚
영웅	영웅 英 雄 儫
영지	영지 埰
예도	예도 禮
예물	예물 幣
예쁠	예쁠 佼
예쁠	예쁠 姣 嫫 媚 丰 嫙 娥 嫈 婉 姚 姝 倩 娙 婲
오구	오구 汕
오랠	오랠 久 奄 永 淫
오를	오를 登 騰 躡 乘 昇 升 陞 昻 襄 敭 躋 陟
오리	오리 鳧 鴨
오얏	오얏 李
오이	오이 瓜
오장	오장 臟
오줌	오줌 尿 溲 便
오직	오직 唯 惟 維 聿 伊 爾
오행	오행 行
옥돌	옥돌 玕 琨 璝 玖 瑙 碼 珷 珉 玟 玞 琇 瓔 瑤 瑀 玗 珢 瑨 璡
옥빛	옥빛 璘 瑛 璘 縹 現
옥새	옥새 璽
옥잔	옥잔 斝
옥저	옥저 琯
옥패	옥패 玦
옥홀	옥홀 琮 瓛
온역	온역 瘟
올릴	올릴 杠 陞
올벼	올벼 稙
옮길	옮길 挪 般 搬 徙 移 遷 推
옳을	옳을 可 韙 猷 義 宜 誼 好
옷깃	옷깃 襟 衿 領 衽
옷섶	옷섶 襟
옷속	옷속 裡 裡
옹이	옹이 枙
옹저	옹저 著
옹풀	옹풀 蓊
와개	와개 猧
완두	완두 豌
왕골	왕골 菅
왕대	왕대 篩
왕비	왕비 妃
외씨	외씨 瓣
외울	외울 諷
외칠	외칠 嘖 嘷 嚄
왼쪽	왼쪽 左
요령	요령 釪 鐸
요리	요리 烹
요물	요물 孼
요일	요일 曜
요행	요행 僥 倖
욕될	욕될 辱 恥
욕할	욕할 罵
우뢰	우뢰 雷 雷
우리	우리 雷 窂 雷 牢 笠 峰 笠 柵 檻 柙
우물	우물 井
우박	우박 雹
우산	우산 蓋 傘
우엉	우엉 蒡
우편	우편 郵
운삽	운삽 翣
운수	운수 運
운치	운치 韻
운풀	운풀 蕓
울릴	울릴 轟 風 嚮 嚆
울림	울림 韻
울짱	울짱 寨 柵
움집	움집 窩
움킬	움킬 抔 朶 攫
웃을	웃을 謚 嘻 暿
웃음	웃음 笑
원님	원님 守 倅
원래	원래 素
원수	원수 仇 讐 讎 怨 敵
원앙	원앙 雎
원집	원집 院
원한	원한 冤
원할	원할 乞 願
월급	월급 薪
월식	월식 蝕
위엄	위엄 勢 威 風
위옥	위옥 瑋
윗옷	윗옷 表
윗턱	윗턱 卾
유도	유도 儒
유리	유리 琉 璃
유약	유약 琺
유자	유자 柚
유풀	유풀 蕕
유황	유황 硫
육발	육발 跂
윤낼	윤낼 磋
율무	율무 薏 苡
으뜸	으뜸 魁 丕 元 宰 霸
으를	으를 怯
은행	은행 杏
은혜	은혜 施 恩 寵 惠
읊을	읊을 嘯 詠 咏 吟
음기	음기 陰
음도	음도 膣
음률	음률 呂
음식	음식 需 羞 獻
음악	음악 音
읍할	읍할 揖
응당	응당 應
응할	응할 應 膺
의기	의기 俠
의리	의리 意 義
의원	의원 醫
이것	이것 這
이길	이길 堪 戡 龕 肩 克 剋 捏 勝 載 捷 擢
이깝	이깝 餌
이끌	이끌 牽 導 惹 爰 引
이끼	이끼 蘚 苔
이룰	이룰 成 盛 遂 玉 爲 凝 績 就
이를	이를 格 屆 到 夙 如 詣 云 謂 氐 早 至 臻 洊 詹 致 溘 訖 迄
이름	이름 乭 名
이리	이리 狼 狼 狸 狽
이마	이마 顙 額 顚 頂 題
이모	이모 姨
이문	이문 閭 閭
이미	이미 旣 夙 已
이불	이불 衾 被
이삭	이삭 秀 穗 穎
이슬	이슬 露 露 沆
이엉	이엉 蓋 苫
이에	이에 乃
이에	이에 迺 而
이웃	이웃 隣 鄰 隣
이을	이을 賡 繼 係 繗 絣 嗣 紹 系 韶 續 受 述 承 繩 維 丞 胤 績 傳 纘 屬 統
이제	이제 今
이질	이질 痢 瘕
이치	이치 理 數
익새	익새 鷁
익을	익을 忸 俗 孰 熟 治
익힐	익힐 講 練 熟 習 狎 胤 肄 飪 便
인가	인가 乎
인간	인간 世
인끈	인끈 紱 綬 綎
인륜	인륜 倫
인민	인민 億
인삼	인삼 蔘
인연	인연 緣
인치	인치 吋
인할	인할 因 仍
일가	일가 姓 親
일곱	일곱 七
일만	일만 萬 万
일백	일백 百
일산	일산 繖
일식	일식 蝕
일찍	일찍 豈 豈 曾
일천	일천 千 仟
일할	일할 拮 勞 勞
읽을	읽을 讀 讀 誦
잃을	잃을 損 失 外 墜 墮
임금	임금 乾 君 辟 首 叡 王 元 帝 僦 皇 后
임질	임질 痳
임할	임할 臨
입가	입가 吻
입술	입술 吻 脣
입을	입을 蒙 服 衣 佗 擐
입힐	입힐 緡
잇달	잇달 聯
잇몸	잇몸 車 腭 齶 齗
있을	있을 有 在 存 見
잉어	잉어 鯉
잊을	잊을 忘 諠
자고	자고 鴣 鷓
자기	자기 己 我 卬 言 俺 余 予 吾
자네	자네 若
자라	자라 鱉 鼉
자라	자라 鼈
자랄	자랄 贏 育
자루	자루 袋 柄 棅 枘 橐
자를	자를 刎 苅 揃 折 切
자리	자리 席 蓆 位 茵 座 榻 宅
자못	자못 頗
자석	자석 磁
자식	자식 孥 息
자을	자을 紡
자주	자주 頻 數 數
자지	자지 腎
자취	자취 跡 蹟 迹 踪 蹤 躅
작다	작다 幺
작약	작약 芍
작을	작을 藐 微 細 小 宵 幺 扁
잔교	잔교 棧
잔꾀	잔꾀 略
잔다	잔다 寐
잔치	잔치 燕 讌 享
잠간	잠간 咋 倏 臾
잠글	잠글 籥
잠길	잠길 沕 浧 湮 潛 沈 湛
잠깐	잠깐 乍 少 瞬 臾
잠깰	잠깰 寤
잠시	잠시 暫
잠잘	잠잘 寐 眠 寢
잡될	잡될 雜
잡을	잡을 撿 拘 撚 屠 攬 撈 秉 扮 手 收 握 掜 操 摯 執 捉 把 夾
장군	장군 缶
장기	장기 瘴
장끼	장끼 鷂
장농	장농 欌
장님	장님 瞍
장단	장단 囃
장대	장대 竿
장롱	장롱 欌
장마	장마 霖 霪 霔 滈
장막	장막 幕 幄
장물	장물 贓
장미	장미 蘼
장부	장부 簿 腑 胕
장사	장사 賈 商 販
장삼	장삼 衲
장수	장수 帥 將 摠
장인	장인 工 匠
장정	장정 丁
장차	장차 將
장할	장할 壯
재갈	재갈 箝 銜 啣
재목	재목 材
재물	재물 用 資 貲 財 貝 幣 貨 賄
재상	재상 宰
재앙	재앙 殃 厄 夭 祅 災
재주	재주 技 伎 佞 倆 術 藝 芸 才 材
재화	재화 貨 禍
잿빛	잿빛 儵
쟁기	쟁기 耒 耦
쟁반	쟁반 槃
저구	저구 雎
저녁	저녁 夕
저릴	저릴 痲 痹
저물	저물 晩 暮 側
저밀	저밀 切
저승	저승 閻 幽
저울	저울 錘 鎚 秤
저자	저자 市 井 就
저주	저주 呪
적대	적대 肵
적병	적병 痃
적삼	적삼 衫
적실	적실 灓 溲 濡 淫 瀸 浸 濯
적을	적을 儉 歉 寡 厪 些 尠 小 少 幽 勻 標
적취	적취 癖 癥
전갈	전갈 蝎 蠍
전기	전기 電
전대	전대 橐
전동	전동 箙
전례	전례 套
전방	전방 廛 鋪
전복	전복 鰒
전부	전부 十
전어	전어 鮗 鱣
전자	전자 篆
전풀	전풀 荃
전할	전할 傳 馳
절개	절개 槪 節
절구	절구 臼
절벽	절벽 陡
절일	절일 醃 鹽 沾
젊을	젊을 少 婉 娵
점괘	점괘 卦
점대	점대 筮
점심	점심 餉
점점	점점 漸 稍 寖
점칠	점칠 卜 隱 占
점판	점판 栻
접때	접때 曩
접을	접을 摺
젓갈	젓갈 鮨
정기	정기 精
정미	정미 粲
정보	정보 町
정사	정사 政
정성	정성 慤 懇 虔 悃 悾 款 誠 愿 衷 忱
정신	정신 神
정실	정실 嫡
정오	정오 晌
정월	정월 陬
정자	정자 榭 亭
정할	정할 勘 粹 奠 定 精 宅 蔽
젖을	젖을 答 濕 浥 銋 霑 寖 涵
제기	제기 毬 瓚
제당	제당 瑅
제도	제도 式 制
제목	제목 題
제방	제방 坡
제비	제비 燕 鷰 鳦 籤
제사	제사 祀 祭 亨
제터	제터 壇 畤
제호	제호 醐
조각	조각 版 片
조개	조개 貝 蛤
조건	조건 件
조금	조금 少 寸 錙
조두	조두 柝
조류	조류 藻
조리	조리 籔 笊
조목	조목 條 則
조묘	조묘 祧
조사	조사 於
조상	조상 祖
조서	조서 詔
조세	조세 政
조수	조수 汐 潮
조정	조정 廷
조짐	조짐 禨 兆
조카	조카 姪 桎
족보	족보 譜
졸음	졸음 睡
졸할	졸할 拙
좀놈	좀놈 細
좁쌀	좁쌀 粟
좁을	좁을 陋 陋 小 隘 戹 窄 促 褊 狹 陜
종기	종기 瘙 瘍
종독	종독 癆
종류	종류 種
종묘	종묘 廟
종양	종양 癌
종이	종이 紙
좇을	좇을 屬 率 順 循 殉 紃 侚 述 侍 沿 允 適 從 遵 趁 就
좋을	좋을 哿 良 妧 儀 賢 好
주검	주검 屍 尸
주낼	주낼 註
주두	주두 枓 欂
주름	주름 紋 襞 皴 縐
주릴	주릴 饉 飢 饑 餓
주막	주막 邸 傳 店
주먹	주먹 拳
주문	주문 籒
주발	주발 椀 碗
주사	주사 硃
주살	주살 弋 矰
주석	주석 詁 錫
주악	주악 粽
주울	주울 捃 叔 拾 拾 拓 摭 掇 拓
주인	주인 主
주일	주일 週
죽순	죽순 筍 篛
죽을	죽을 涅 歿 死 喪 殊 殞 殂 斃 獘 薨
죽일	죽일 戡 虔 屠 劉 戮 殺 煞 殺 刈 戕 剿 害 刑
준걸	준걸 傑 杰 俊
준마	준마 驁 駿 驊
줄기	줄기 幹 莖 枚
줄일	줄일 歙
줄춤	줄춤 佾
줄칠	줄칠 罫
줍을	줍을 陋 陋
줏대	줏대 輨
중량	중량 鎰
중매	중매 媒
중완	중완 脘
쥐통	쥐통 痧
즐길	즐길 衎 嗜 樂 樂 樂 譽 傲 樂 悰 耽 眈 嬉
증거	증거 證
증세	증세 症
지게	지게 戶
지경	지경 疆 畺 境 界 堺 區 圻 畔 域
지금	지금 現
지날	지날 客 過 歷 歷 郵 由 逾 蹉 觸
지낼	지낼 距 歷
지네	지네 蚣 蜈 蛆
지라	지라 脾 膵
지레	지레 杆
지류	지류 汜
지모	지모 蕁
지방	지방 県
지붕	지붕 廡 屋
지을	지을 俶 述 營 傭 聿 作 製 造 做 撰
지질	지질 灸 烙 烙 焠 煮
지초	지초 芝
지치	지치 茈
지칠	지칠 蒿
지킬	지킬 保 守 宿 完 圍 衞 頀
지혜	지혜 若 智 慧
직분	직분 職
진문	진문 轅
진실	진실 誠
진액	진액 液 汁 澤
진주	진주 珠
진칠	진칠 屯 陣
진펄	진펄 隰 沈 澤
진흙	진흙 墐 濘 淖 泥 塗 淤
질책	질책 軸
짐새	짐새 鴆
짐승	짐승 獸
짐질	짐질 負 輿
집개	집개 鋏
집게	집게 鋏
집대	집대 坮
집터	집터 垈
짖을	짖을 吠 嘷
짙을	짙을 濃
짚을	짚을 據
짧을	짧을 短 促
쪼갤	쪼갤 劈 剖 析 斫 斱 柝 判 片 解 劃
쪼을	쪼을 啄
쪽지	쪽지 票
쫓을	쫓을 去 遣 追 逐
쭉지	쭉지 翮
찌끼	찌끼 渣 垽 滓 澱
찌를	찌를 感 戡 激 刲 剚 刺 觝 牴 擉 攙 刺 觸 鏦 衝 針 剽
찍을	찍을 捏 捻
찢을	찢을 桀 裂 剝 裂 偖 磔 坼
찣을	찣을 撝
찧을	찧을 搗 擣
차꼬	차꼬 桎
차례	차례 序 敍 順 循 承 悛 第 秩 奕
차반	차반 托
차자	차자 箚
차조	차조 秫
차차	차차 漸
차풀	차풀 茶
착할	착할 价 凱 善 聖 淑 馴 愿 臾 臧 衷
찰벼	찰벼 糯 稌
참마	참마 薯
참빗	참빗 枇
참새	참새 雀
참서	참서 讖
참을	참을 忍
창고	창고 宬
창녀	창녀 娼
창병	창병 疳
창자	창자 腔 腸
창졸	창졸 曓
창질	창질 癘
창틀	창틀 棨
창포	창포 菖 蒲
찾을	찾을 求 覓 摸 訪 索 需 搜 蒐 尋 取 探 討
채색	채색 彩
채울	채울 找
채찍	채찍 策 箠 鞭
책갑	책갑 帙
책력	책력 曆 曆
책상	책상 机 檔 案 卓 榥
책편	책편 編
처마	처마 廡 楣 宸 簷 檐
처음	처음 俶 始 新 初 太
천궁	천궁 蘼
천벌	천벌 災
천신	천신 神
천정	천정 井
천치	천치 憃
천할	천할 廝 傖 賤
첨대	첨대 笒
첩지	첩지 編 髲
청서	청서 鼬
청어	청어 鯖
청할	청할 聘 召 請
초례	초례 醮
초막	초막 庵
초목	초목 植
초산	초산 醋
초석	초석 硝
초헌	초헌 軒
촛대	촛대 錠
촛불	촛불 燭
추녀	추녀 榮 樀
추릴	추릴 捎 擇
추할	추할 疏 莠 醜 皺
축시	축시 丑
춤출	춤출 舞 娑 僊
충성	충성 忠
충치	충치 齲
췌장	췌장 膵
취할	취할 龕 弋 采 取 探 撐
층계	층계 段
치마	치마 裙 裳
치성	치성 徵
치자	치자 梔
치질	치질 痔
칙령	칙령 勅
칙서	칙서 敕
친할	친할 膺 親 肺 倖
칡범	칡범 彪
침방	침방 閤
침향	침향 樒
칼끝	칼끝 鋒
칼날	칼날 鋒 刃 鏢
칼집	칼집 建 鞬 鞘
코골	코골 鼾
코피	코피 衄
콧물	콧물 洟
콩잎	콩잎 藿
콩팥	콩팥 腎
쾌자	쾌자 褕
쾌할	쾌할 愃 快 愜
큰곰	큰곰 貊
큰길	큰길 逵
큰물	큰물 洪
큰배	큰배 舶 膨
큰산	큰산 嶽
타락	타락 酪 酪
타조	타조 鴕
탄알	탄알 彈
탐할	탐할 愷 健 叨 饕 婪 恈 忨 饞 餮 飻 貪
탓할	탓할 尤
태보	태보 胞
태산	태산 岱
태울	태울 焠
태장	태장 鞭
태주	태주 蔟
태풍	태풍 颱
터럭	터럭 毛 髮
터울	터울 煗
터전	터전 廛
터질	터질 炸 坼 拆
턱뼈	턱뼈 顎
털긴	털긴 毿
털끝	털끝 釐
털베	털베 褐
털뿔	털뿔 觜
텅빈	텅빈 壙
토끼	토끼 卯 毚
토담	토담 壝
토란	토란 芋 鴟
토막	토막 椹
토할	토할 咯 喀 歐 嘔 瀉 吐
톱끝	톱끝 繢
통발	통발 汕 筌
통부	통부 訃
통할	통할 開 涇 逞 聖 演 睿 用 穿 徹 泰 兌 透
투계	투계 鶸
투구	투구 鎧 兜 胄
퉁길	퉁길 彈
퉁소	퉁소 簫 匏
튀기	튀기 駏
트일	트일 闊
티끌	티끌 芥 厘 坱 埃 塵
파리	파리 蠅
파벌	파벌 派
파초	파초 蕉 芭
파할	파할 綻 罷
판금	판금 鉼 鏶
판수	판수 瞍
팔뚝	팔뚝 肱 腕
팔릴	팔릴 衒
팔찌	팔찌 拾 釧
패백	패백 贄
패옥	패옥 玘 璲 珵 佩
패왕	패왕 霸
패할	패할 摺 敗
퍼질	퍼질 濫 濫 洩 濩
편지	편지 牘 音 札 槧 牒 畢
편할	편할 易 佚 便
펼칠	펼칠 演 展 攤 攄 播 佈
평복	평복 褻
평상	평상 床 牀 榻
평생	평생 世
평수	평수 坪
평지	평지 蕓
폐단	폐단 弊 獘
폐백	폐백 贄 雉 幣
폐슬	폐슬 韍
폐할	폐할 寘 廢
포갤	포갤 佹 累 積 疊
포도	포도 葡
포로	포로 虜 虜
포승	포승 縲
폭포	폭포 湫
표기	표기 幟
표범	표범 豹
표제	표제 帖
표할	표할 旌 識 標
푯말	푯말 桓
푸를	푸를 碧 蒼 靑 蔥 翠
풀릴	풀릴 頖 消
풀막	풀막 樔
풀무	풀무 鞴
풀벨	풀벨 芟 芻
품수	품수 程 品
품을	품을 擁 抱 挾 懷
품할	품할 稟
풍경	풍경 箏
풍년	풍년 歲 平
풍류	풍류 呂 聲 樂
풍병	풍병 痔 痓
풍속	풍속 俗 風
풍신	풍신 二
풍치	풍치 致
풍칠	풍칠 詫
피륙	피륙 布
피리	피리 管 筦 籥 龠 笛
피부	피부 膚
피할	피할 閃 孫 迂 躱 避 諱
하나	하나 壹
하늘	하늘 堪 乾 旻 霄 宇 雲 元 天 祆 靝 虛 玄 昊
하인	하인 儓 皁
하품	하품 欠
학교	학교 校 泮 庠 雍 雝 院
학질	학질 瘧 痎
한될	한될 恨
한수	한수 漢
한숨	한숨 愾
한정	한정 程
한할	한할 憾
할미	할미 嫗 姥 媪 婆
핥을	핥을 舐
함거	함거 轞
함께	함께 共 俱 以 互
함정	함정 穽
합할	합할 襲 友 總 合 盍 翕
항간	항간 閻
항구	항구 港
항렬	항렬 行 行
항목	항목 項
항문	항문 肛
항상	항상 常 恒
항쇄	항쇄 鎖
항아	항아 姮
항통	항통 缿
해감	해감 垽
해갓	해갓 獬
해골	해골 髗 髑
해구	해구 膃
해굴	해굴 髏
해리	해리 浬
해자	해자 楷 濠 壕 隍 湟
해질	해질 暌 弊 晡
해추	해추 鰌
해충	해충 蝥
해칠	해칠 忮 殘 賊
해할	해할 枳 害
햇길	햇길 躔
햇발	햇발 晛
햇불	햇불 炬 燎 燎
햇빛	햇빛 旲 暐 昡 晃 暉 曦
햇솜	햇솜 緜
햇수	햇수 垓
행담	행담 篋
행랑	행랑 廂
행복	행복 祿
행서	행서 行
행실	행실 行
행장	행장 諡 裝
행적	행적 蹟
행주	행주 帉
향기	향기 芳 馥 臭 香 薌 馨
향낭	향낭 幃
향내	향내 匂 香 焄
향불	향불 薰
향초	향초 菰
향풀	향풀 松 芸 荃 薰
향할	향할 首 向 嚮
허리	허리 要 腰
허물	허물 愆 辜 咎 罪
허파	허파 肺
헌곳	헌곳 瘻
헌데	헌데 疔
헌솜	헌솜 絡 絮
헐릴	헐릴 阤
험할	험할 坷 坎 蹇 崎 巖 嵬 阻 嵯 險
헛간	헛간 廠
헛될	헛될 虛
헤멜	헤멜 仿
헤칠	헤칠 拓 撐 攄 把 擺 披
현미	현미 糲
현인	현인 才
협기	협기 俠
형구	형구 枷
형벌	형벌 炮 刑
형상	형상 狀 像 影 形
형세	형세 意
형수	형수 嫂
형틀	형틀 械
혜성	혜성 杵 孛
혜초	혜초 蕙
호걸	호걸 傑 豪
호경	호경 鎬
호련	호련 璉
호미	호미 錤 鋤 鉏 鎡
호박	호박 珀 琥
호반	호반 武
호수	호수 湖
호적	호적 籍 版
호패	호패 牌
호할	호할 糢
혹시	혹시 倘
혼날	혼날 懲
혼인	혼인 姻
홀로	홀로 單 獨
홀연	홀연 倏 忽
홈통	홈통 篊
홍역	홍역 痲 疹
홑옷	홑옷 褧 顈 袗
화덕	화덕 烓
화로	화로 爐 爐 鑪
화살	화살 矢 箭
화재	화재 劫
화전	화전 畑
화초	화초 爐 爐
화할	화할 穆 雍 怡 諴 和 俰 洽 凞
환관	환관 宦
환말	환말 驩
환어	환어 鰥
환할	환할 熠 煒 倬 晫 晥
환형	환형 轘
활꼴	활꼴 窿
활집	활집 櫜 韜 弢
황달	황달 癉 疸
황모	황모 蒯 蕫
황새	황새 鸛 雚
횃대	횃대 竿 桁
횃불	횃불 炬 烘
회충	회충 蠱
회칠	회칠 膾
횡액	횡액 災
효도	효도 孝
후렴	후렴 鹽 囀
후사	후사 胄
후손	후손 裔
후추	후추 椒
훔칠	훔칠 偸
훨할	훨할 噲
휘일	휘일 折
휘장	휘장 褘 帷 帳 幬 幨 幰 幌
휩쌀	휩쌀 呑
흉작	흉작 侵
흉터	흉터 瘢 痕
흉할	흉할 凶
흐를	흐를 滾 流 衍 洹
흐릴	흐릴 淈 曖 濊 佚 濁 渾 惛
흑토	흑토 壚
흔들	흔들 撼 掉 搖
흘길	흘길 眥
흙손	흙손 墁 鏝 圬
흠각	흠각 玷
흠집	흠집 痍
흩을	흩을 散 泄 攄
희생	희생 胖 牲 犧
희일	희일 揉
흰떡	흰떡 餌
힘셀	힘셀 劤
힘쓸	힘쓸 努 勵 勉 俛 務 懋 亹 娓 黽 贔 勖 憖 孜
힘줄	힘줄 腱 筋
가	가 邊
간	간 肝
갈	갈 去 朅 乬 耭 厲 轣 礱 磨 摩 麿 邁 逝 砑 硏 往 于 逾 冘 征 徂 丟 之 磋
감	감 枾 柹
갑	갑 匱
값	값 價 賈 估 値
갓	갓 芥 冠
개	개 狗 戌 浦
갤	갤 霽 晴
건	건 幞 幘
걸	걸 羂 掛 卦 罣
겁	겁 劫
겉	겉 表
게	게 蟹
겨	겨 糠 穅
겹	겹 層
곁	곁 傍 側 夾
곧	곧 卽 就
곰	곰 熊
곱	곱 倍
곳	곳 居 所 攸 在 處 圃
공	공 功 績 勳
관	관 椁 柩 柾 卡 櫬
광	광 壙
괘	괘 夷
국	국 羹
굴	굴 蠣 窩 穴
굽	굽 蹄
굿	굿 穴
궤	궤 匣 槨 橙
귀	귀 耳
그	그 厥 其 該
근	근 斤
글	글 書 藝 章 箋 牋 藻 箚 諧
금	금 鏋
기	기 旗 旂 幢 幡 烟 旃 旆
길	길 路 道 途 涂 路 曼 匐 脩 隧 縯 永 儥 猗 仞 長 丈 程
김	김 汽
깁	깁 絹 紗
깃	깃 翎 翅 羽
꼭	꼭 應
꼴	꼴 秣 儀 芻
꽃	꽃 蕊 花 華
꾀	꾀 計 謨 猷 諮 策
꾈	꾈 誂
꿀	꿀 蜜
꿈	꿈 夢
꿩	꿩 翟 雉
꿸	꿸 貫 串
끈	끈 組
끌	끌 銶 掎 輓 曼 扳 夆 銑 攝 曳 引 提 鑽 鏨 拕 携
끝	끝 季 端 末 叔 倪 杪 剽 疋
끼	끼 兎
낄	낄 介 聶 抱 挾 夾
나	나 儂 我 余 予 吾 朕
날	날 經 翺 飜 翻 飛 生 屳 殖 辰 育 日 辰 出
납	납 鉛
낫	낫 剴 鎌 釤
낮	낮 午 晝
낯	낯 面
낱	낱 個 箇
내	내 川
너	너 汝 戎 而 爾
넉	넉 四
넋	넋 魄 魂
널	널 棺 柾 槥
넷	넷 四
년	년 豊
노	노 櫂 橈 楫
녹	녹 俸 鉎
논	논 畓 田
놀	놀 遊 濯 霞
놈	놈 者
농	농 簽
눈	눈 目 雪 眼
늘	늘 恒
능	능 陵 臺 園
늪	늪 沼 湫 澤
다	다 皆 僉 咸
단	단 緋 甛
달	달 甘 月 輇 甛 樞
닭	닭 鷄 雞 酉
담	담 堵 塀 墻 牆 廧 堞
닻	닻 錨
대	대 竹
덜	덜 減 搫 省 捎 損 除
독	독 堈 蠱 毒 甕 瓮
돈	돈 銀 錢 幣 布
돌	돌 朞 邏 邏 石 旋 巡 循 硯 週 回 廻
돐	돐 歲 晬
돛	돛 帆 颿
돝	돝 豕
되	되 升
될	될 化
두	두 兩 二 貳
둑	둑 防 堤
둘	둘 建 兩 兩 貯 措 置 寘 匹
뒤	뒤 後
들	들 擧 揵 挌 坰 擎 郊 撟 擡 坮 們 入 提 抗
등	등 尾 背
따	따 堃
딸	딸 摘
땀	땀 汗
땅	땅 坤 地
때	때 垢 時 秋
떡	떡 糕 餠
떨	떨 拂
떼	떼 隊 筏 楂 灄 橃
또	또 亦 又 有 且
똥	똥 糞 矢 屎
뛸	뛸 距 跳 踉 躍 踴 越 跳 蹠
뜰	뜰 汎 浮 庭 漂
뜰	뜰 泛
뜸	뜸 篷
뜻	뜻 味 意 義 情 志 旨 趣 態
띠	띠 緄 帶 茅
름	름 夷
리	리 蕭 翛 俏
마	마 藷
막	막 幕 膜 幔 帳
맏	맏 孟 伯
말	말 蕁 斗 馬 莫 毋 勿 弗 辭 午
맛	맛 味 飴
매	매 榜 鴘 鷹
맥	맥 脈
맬	맬 介 繫 縈 繯
먹	먹 墨
멀	멀 隔 遼 邈 疏 遙 姚 迂 遠 悠 狄 逖 迢 趠 逴 遐 懸 洵 泂 逈 夐
멜	멜 揵 桀 肩 贏 夯
몇	몇 幾 數
모	모 楞 稜 苗 方 秧
목	목 頸 脰 亢 頏
몫	몫 結
몰	몰 驅
몸	몸 軀 躬 己 身 肉 體 体 軆 形
못	못 睾 皋 潭 沼 淵 瀦 釘 池 澤
뫼	뫼 巒 山
무	무 蘿 菔
문	문 門
물	물 江 齧 水 嘬 河
뭇	뭇 庶 品
뭍	뭍 陸 墺 土
밀	밀 蠟 蠟
및	및 曁
밑	밑 本 隶 底
바	바 所
박	박 匏
반	반 半
발	발 簾 箔 足 止 趾
밤	밤 宵 夜
밥	밥 飯 食
방	방 房 室 寢
밭	밭 田 畑 畠
배	배 艟 梨 舶 舫 舽 珤 腹 船 艘 舟
뱀	뱀 巳 蛇 巴
벌	벌 范 蜂
범	범 寅 虎
법	법 綱 檢 規 律 模 範 笵 法 紃 繩 式 臬 彝 典 程 準 准 楷 憲
벗	벗 朋 友 匹
베	베 布
벨	벨 馘 芟 苅 荑 斫 誅 斬 討 割
벼	벼 稻 籾 禾
벽	벽 壁
변	변 屎
별	별 景 奎 霰 星 酉 台
병	병 病 甁 慍 憂 疾 壺
볕	볕 景 陽
보	보 洑
복	복 祺 祿 福 禔 禔 鮧 祚 胙 祉 鮭 祜 禧
볼	볼 看 監 見 觀 睹 覩 覽 視 顋 閱 覿 診 瞻 矚 見
봄	봄 韶 春
북	북 鼓 梭 杼 柚
분	분 鉛
불	불 蕃 燧 吹 噓 火 喣 燬 爔
붓	붓 聿 筆
비	비 碣 雨 箒 帚 彗
빌	빌 匃 祛 罄 空 窾 曠 祈 禱 素 呪 借 祝 洞 虛 洫
빗	빗 櫛
빚	빚 債
빛	빛 光 色 暉
빨	빨 湔 吮 澣
뺄	뺄 拔 扒 楯 挺 珽 扎 抽 擢
뺨	뺨 顋 頰
뼈	뼈 骨 骸
뿐	뿐 翅 啻 寔
뿔	뿔 角
삯	삯 傭
산	산 岵
살	살 居 購 肌 買 棲 矢 寓 肉 在 住 處 宅 活
삵	삵 貍
삼	삼 麻 繆
새	새 禽 新 乙 鳥 隹
샐	샐 漏 漏 泄 洩
샘	샘 腺 源 泉
석	석 三 參
석	석 參
설	설 立 立
섬	섬 島 嶋 嶼 洲
성	성 嬀 金 姞 廖 劉 閔 卞 宓 葉 沈 氏 曺 涍 姬
섶	섶 柴 薪
셀	셀 勍 計 算 揲
소	소 牛 丑
속	속 裏 奧
손	손 賓 手
솔	솔 筅 松
솜	솜 絖 纊 綿 絮
솥	솥 錡 錪 鼎
쇠	쇠 鋼 金 金 錪 鐵
수	수 黼 黻
술	술 酒 春
숨	숨 羲
숯	숯 炭
숲	숲 薄
쉴	쉴 偈
쉴	쉴 憩 闋 棲 說 稅 臥 靜 寘 寢 歇 休
신	신 履 舃 鞋 靴
실	실 縷 縷 絲 線 純
싹	싹 芒 萌 苗 芽 蘖 茁
쌀	쌀 裹 米 齎 包
써	써 以
썰	썰 膞
쏠	쏠 發 射 彈
쑥	쑥 蔞 蓬 蕭 菴 艾 荻 蒿
쓸	쓸 苦 費 書 掃 埽 率 施 式 用 庸 由 以
씨	씨 芢 種 核 覈
안	안 內
알	알 卵 卵 粒 識 悉 認 粒 知 識 丸
앞	앞 前
약	약 藥
양	양 羊
억	억 巨 億
얼	얼 凍 冱
연	연 荷
열	열 開 闓 胠 啓 闢 十 敞 闡 攤 擺
엿	엿 糖 餳 餹 飴
옆	옆 仄
옛	옛 古 故 舊 昔 往 前 恒
옥	옥 瓊 琪 囹 琁 圄 狴
올	올 格 來 來 徠
옴	옴 疥 癬 瘙 痒
옷	옷 服 衫 衣
외	외 瓜
왼	왼 左
욀	욀 誦 諳 諷
요	요 裀
용	용 龍
운	운 韻
울	울 呱 哭 唳 嘹 鳴 樊 呝 吟 啼 吼
움	움 穴
위	위 上
은	은 鐐 銀
을	을 囃
이	이 斯 蝨 時 是 諟 寔 齬 伊 玆 此 齒
일	일 賡 淘 務 事 業 縡 興
입	입 口
잎	잎 葉
자	자 尺
잔	잔 杯 盃 觴 巵
잘	잘 麽 碎 宿
잠	잠 睡
장	장 醬 墟
재	재 嶺 岺 城 灰
잴	잴 輇 揣
쟁	쟁 箏
저	저 伊 他 佗 彼
절	절 伽 拜 寺 院 刹
점	점 卜
젓	젓 鮓 醢
젖	젖 奶
젖	젖 嬭 乳
제	제 食
조	조 粟
졸	졸 盹
좀	좀 蠹
종	종 奴 鎛 僕 奚 鐄
죄	죄 愆 罰
죽	죽 糜 粥
줄	줄 匃 苽 贛 罫 給 乞 鑢 列 賚 耗 絆 付 賜 送 授 施 貽 蔣 乼 贈 陣 投 稟 鎣 貺
중	중 僧
쥐	쥐 鼠
쥘	쥘 摯
즙	즙 液 汁
진	진 壘 壘 營
질	질 擔 負 絰
집	집 家 堂 宅 廡 舍 戍 宸 室 屋 宇 齋 邸 第 宙 宅
징	징 鑼 鋲 錚 鉦
짚	짚 稈 藁
짝	짝 仇 逑 侶 儷 伴 配 讎 雙 仵 隻 匹 疋 合 伉
짤	짤 絍 組 織 搾 鹹
쪽	쪽 藍 藍
쫄	쫄 琢
쯤	쯤 所 啻
찔	찔 蒸
차	차 茶
찰	찰 冷 凜 冷 冽 凜 凛 滿 盈 踶 滄 凔 蹴 佩 珮 寒 泂 冱
참	참 寔 諶 眞
창	창 毄 棨 戈 戵 屢 屢 矛 槊 鈒 戞 鈗 鎗 釘 窓 槍 窻 窗 鏦
책	책 卷 傳 冊 篇 畢 典
첩	첩 妾 寵
체	체 篩
초	초 酸 酢 漿 酢 醯
총	총 鎗 銃
춤	춤 佾
치	치 寸
칠	칠 搉 擊 挌 攻 撾 韃 撞 牧 拍 搏 伐 扑 批 渫 手 征 濬 椎 槌 打 涿 抬 討 捌 摽
칡	칡 葛
침	침 涎 針 鍼 唾
칼	칼 劍 劒 刀
캘	캘 採 采
코	코 鼻
콩	콩 豆 荳 荏 太
큰	큰 大 德
클	클 介 价 巨 渠 鉅 廓 侊 傀 宏 譚 大 隆 牟 厖 甫 溥 賁 汾 丕 邳 奭 碩 蓆 俺 偉 戎 殷 懿 奬 奘 麤 濯 倬 誕 太 泰 誧 項 奕 浩 顥 弘 廓 奐 恢
키	키 箕 舵 柁 簸
탈	탈 乘 焦 馱 搭
탑	탑 塔
터	터 基 垈 址 阯
턱	턱 顎 頦
털	털 毛 帚
테	테 箍
톱	톱 鋸
통	통 筒
틀	틀 龜 機
틈	틈 間 隙 罅 穴
티	티 瑕
파	파 蔥
판	판 局 槧
팔	팔 沽 搰 掘 賣 臂 售 儥 販
패	패 牓 札
팰	팰 惉
펼	펼 敷 溥 舒 申 伸 傳 暢 吐 鋪 披
포	포 胊 膴 膊 腊 脩 脯
폭	폭 幅
표	표 牋
풀	풀 開 闓 苟 卸 抒 釋 蔿 揉 黏 草 艸 豸 解 糊 卉 芔
피	피 粢 血
한	한 一 壹
할	할 連 聯 爲
함	함 櫝
합	합 盒
해	해 年 秊 歲 秊
헐	헐 毁
혀	혀 舌 簧
형	형 昆
혹	혹 瘤 贅 或
홀	홀 笏
활	활 弓 弧
홰	홰 桀 塒 楢 弋 燋
회	회 膾 鱠
효	효 爻
휘	휘 斛
흙	흙 壤 土
흠	흠 疵
흰	흰 白
흴	흴 暠 素 皚 皤 皬 皓 縞 皞 皜
힘	힘 力
